MarketID,eq_price,eq_quantity,optimalconsumersurplus,optimalproducersurplus,optimal_surplus,Number_players,default,mean_experience_robot,mean_experience_nonrobot,Quantity,ConsumerSurplus,ProducerSurplus,surplus,efficiency
1001,103,17,894,665,1559,25,0,0.0,0.0,17,1056,167,1223,0.784477229
2001,66,12,156,288,444,15,0,0.0,0.8666667,15,65,225,290,0.653153153
2002,66,12,156,288,444,15,0,0.0,0.46666667,22,-206,260,54,0.121621622
2003,64,2,38,56,94,2,0,0.0,1.0,2,26,68,94,1.0
3001,112,13,260,416,676,10,1,0.0,0.0,12,354,283,637,0.942307692
3002,112,13,260,416,676,10,1,0.0,0.0,11,94,463,557,0.823964497
3003,112,13,260,416,676,10,1,0.0,0.0,13,304,359,663,0.980769231
3004,112,13,260,416,676,10,1,0.0,0.0,15,191,469,660,0.976331361
3005,112,13,260,416,676,10,1,0.0,0.0,12,429,228,657,0.971893491
4001,109,14,301,560,861,10,0,0.0,0.4,14,506,346,852,0.989547038
4002,109,14,301,560,861,10,0,0.0,0.0,14,193,650,843,0.979094077
4003,109,14,301,560,861,10,0,0.0,0.0,12,119,670,789,0.916376307
4004,109,14,301,560,861,10,0,0.0,0.0,12,222,603,825,0.958188153
4005,109,14,301,560,861,10,0,0.0,0.0,13,-219,1005,786,0.912891986
4006,109,14,301,560,861,10,0,0.0,0.0,15,-15,870,855,0.993031359
5001,120,26,650,650,1300,20,0,0.2,0.8,25,456,790,1246,0.958461538
5001,120,26,650,650,1300,20,0,0.2,1.8,25,347,891,1238,0.952307692
5001,120,26,650,650,1300,20,0,0.2,2.8,27,477,755,1232,0.947692308
6001,65,13,780,390,1170,10,0,0.2,4.3,12,264,856,1120,0.957264957
6001,65,13,780,390,1170,10,0,0.2,5.3,10,303,732,1035,0.884615385
6002,65,13,780,390,1170,10,0,0.3,4.2,11,585,520,1105,0.944444444
6002,65,13,780,390,1170,10,0,0.3,5.2,12,306,664,970,0.829059829
6003,65,13,780,390,1170,10,0,0.4,4.6,12,705,395,1100,0.94017094
6003,65,13,780,390,1170,10,0,0.4,5.6,11,543,367,910,0.777777778
7001,550,6,1545,1545,3090,20,0,0.0,0.0,7,-533,3214,2681,0.86763754
7002,550,6,1545,1545,3090,20,0,0.0,0.0,8,1131,1526,2657,0.85987055
7003,550,6,1545,1545,3090,20,0,0.0,0.4,7,2586,-136,2450,0.792880259
7004,550,6,1545,1545,3090,20,0,0.0,0.0,7,867,1814,2681,0.86763754
7005,550,6,1545,1545,3090,20,0,0.0,0.0,8,822,1604,2426,0.785113269
7006,550,6,1545,1545,3090,20,0,0.0,0.15,7,1174,1507,2681,0.86763754
7007,550,6,1545,1545,3090,20,0,0.0,0.0,7,1085,1904,2989,0.967313916
7008,550,6,1545,1545,3090,20,0,0.0,0.0,7,304,1299,1603,0.518770227
7009,550,6,1545,1545,3090,20,0,0.0,0.15,5,1637,861,2498,0.808414239
7010,550,6,1545,1545,3090,20,0,0.0,0.2,8,589,1683,2272,0.735275081
7011,550,6,1545,1545,3090,16,0,0.0,0.25,5,491,1622,2113,0.68381877
9001,65,13,780,390,1170,10,0,0.5,3.1,6,299,361,660,0.564102564
9001,65,13,780,390,1170,10,0,0.5,4.1,6,363,372,735,0.628205128
9002,65,13,780,390,1170,10,0,0.2,3.4,14,284,851,1135,0.97008547
9002,65,13,780,390,1170,10,0,0.2,4.4,12,317,833,1150,0.982905983
9003,65,13,780,390,1170,10,0,0.0,4.0,9,142,763,905,0.773504274
9003,65,13,780,390,1170,10,0,0.0,5.0,8,336,584,920,0.786324786
10001,126,4,50,254,304,10,0,0.0,4.5,8,17,-703,-686,-2.256578947
10002,126,4,50,254,304,10,0,0.0,4.5,9,-529,252,-277,-0.911184211
10003,126,4,50,254,304,10,0,0.0,4.1,10,-143,-326,-469,-1.542763158
10004,126,4,50,254,304,10,0,0.0,5.2,5,41,36,77,0.253289474
10005,126,4,50,254,304,10,0,0.0,5.0,6,-264,379,115,0.378289474
10006,126,4,50,254,304,10,0,0.0,4.7,7,-379,486,107,0.351973684
12001,123,14,196,378,574,12,0,0.0,0.0,14,228,312,540,0.940766551
12002,123,14,196,378,574,12,0,0.0,1.0833334,13,261,261,522,0.909407666
14001,78,13,312,156,468,10,0,0.3,3.7,12,268,182,450,0.961538462
14001,78,13,312,156,468,10,0,0.3,4.7,12,229,193,422,0.901709402
14002,78,13,312,156,468,10,0,0.6,3.4,11,290,158,448,0.957264957
14002,78,13,312,156,468,10,0,0.6,4.4,12,316,128,444,0.948717949
14003,78,13,312,156,468,10,0,0.3,3.7,13,145,277,422,0.901709402
14003,78,13,312,156,468,10,0,0.3,4.7,14,143,299,442,0.944444444
15001,175,3,225,225,450,10,0,0.0,1.6,1,36,64,100,0.222222222
15002,175,3,225,225,450,10,0,0.0,1.6,3,191,59,250,0.555555556
15003,175,3,225,225,450,10,0,0.0,1.6,3,26,274,300,0.666666667
15004,175,3,225,225,450,6,0,0.0,1.3333334,2,262,138,400,0.888888889
16001,117,9,153,261,414,10,0,0.0,0.0,11,129,174,303,0.731884058
16002,117,9,153,261,414,10,0,0.0,0.1,9,-162,468,306,0.739130435
16003,117,9,153,261,414,10,0,0.0,0.0,12,-20,321,301,0.72705314
16004,117,9,153,261,414,10,0,0.0,0.1,8,-265,556,291,0.702898551
16005,117,9,153,261,414,10,0,0.0,0.0,11,171,183,354,0.855072464
16006,117,9,153,261,414,10,0,0.0,0.1,9,-8,313,305,0.736714976
16007,117,9,153,261,414,10,0,0.0,0.0,12,259,11,270,0.652173913
16008,115,6,126,183,309,6,0,0.0,0.0,5,22,204,226,0.731391586
18001,112,13,260,416,676,10,1,0.0,0.0,11,354,281,635,0.939349112
18001,112,13,260,416,676,10,1,0.0,1.0,12,325,320,645,0.954142012
18002,112,13,260,416,676,10,1,0.0,0.0,12,403,224,627,0.927514793
18002,112,13,260,416,676,10,1,0.0,1.0,12,412,248,660,0.976331361
18003,112,13,260,416,676,10,1,0.0,0.0,8,164,310,474,0.701183432
18003,112,13,260,416,676,10,1,0.0,1.0,12,384,202,586,0.866863905
21001,112,13,260,416,676,10,1,0.0,0.0,10,122,438,560,0.828402367
21001,112,13,260,416,676,10,1,0.0,1.0,15,317,343,660,0.976331361
21001,112,13,260,416,676,10,1,0.0,2.0,12,174,438,612,0.905325444
21002,112,13,260,416,676,10,1,0.0,0.0,12,-409,1042,633,0.936390533
21002,112,13,260,416,676,10,1,0.0,1.0,13,67,593,660,0.976331361
21002,112,13,260,416,676,10,1,0.0,2.0,13,84,563,647,0.957100592
22001,112,13,260,416,676,10,1,0.2,2.8,15,409,251,660,0.976331361
22002,112,13,260,416,676,10,1,0.0,2.7,12,615,-45,570,0.843195266
22003,112,13,260,416,676,10,1,0.0,3.0,14,114,555,669,0.98964497
22004,112,13,260,416,676,10,1,0.2,2.8,12,96,537,633,0.936390533
23001,110,21,420,630,1050,16,0,0.0,0.0,24,39,981,1020,0.971428571
24001,116,17,306,578,884,12,0,0.0,0.0,15,288,564,852,0.963800905
25001,100,44,1254,1254,2508,23,0,0.0,0.0,36,1183,939,2122,0.846092504
28001,112,13,260,416,676,10,1,0.0,0.0,8,-34,485,451,0.667159763
28002,112,13,260,416,676,10,1,0.0,0.0,8,611,-128,483,0.714497041
28003,112,13,260,416,676,10,1,0.0,0.0,10,249,272,521,0.770710059
29001,112,13,260,416,676,10,1,0.0,0.0,13,288,375,663,0.980769231
29002,112,13,260,416,676,10,1,0.0,0.0,9,167,357,524,0.775147929
29003,112,13,260,416,676,10,1,0.0,0.0,11,276,366,642,0.949704142
29004,112,13,260,416,676,10,1,0.0,0.0,11,216,419,635,0.939349112
29005,112,13,260,416,676,10,1,0.0,0.0,10,211,375,586,0.866863905
30001,96,7,198,169,367,15,0,0.0,0.0,7,483,-123,360,0.980926431
31001,520,54,13041,13041,26082,20,0,0.0,0.7,65,13698,5214,18912,0.725097769
31002,520,18,4428,4428,8856,6,0,0.0,3.0,18,5723,2818,8541,0.964430894
32001,96,10,155,235,390,10,0,0.0,0.0,11,107,252,359,0.920512821
32001,96,10,155,235,390,10,0,0.0,1.0,9,163,95,258,0.661538462
32002,96,10,155,235,390,10,0,0.0,0.0,8,180,145,325,0.833333333
32002,96,10,155,235,390,10,0,0.0,1.0,9,221,123,344,0.882051282
32003,96,10,155,235,390,10,0,0.0,0.0,5,147,71,218,0.558974359
32003,96,10,155,235,390,10,0,0.0,1.0,6,138,111,249,0.638461538
32004,96,10,155,235,390,10,0,0.0,0.0,10,147,219,366,0.938461538
32004,96,10,155,235,390,10,0,0.0,1.0,7,162,149,311,0.797435897
33001,406,2,708,359,1067,7,0,0.0,0.0,2,519,336,855,0.80131209
33001,406,2,708,359,1067,7,0,7.571429,6.857143,3,516,405,921,0.86316776
33001,406,2,708,359,1067,7,0,7.571429,7.857143,3,583,285,868,0.813495783
33001,406,2,708,359,1067,7,0,7.571429,8.857142,3,847,74,921,0.86316776
33001,406,2,708,359,1067,7,0,7.571429,9.857142,2,868,199,1067,1.0
35001,112,13,260,416,676,10,1,0.4,1.2,9,-269,752,483,0.714497041
35001,112,13,260,416,676,10,1,0.4,2.2,4,-78,358,280,0.414201183
39001,105,12,276,330,606,9,0,0.0,2.7777777,8,424,84,508,0.838283828
39002,105,12,276,330,606,9,0,0.0,2.2222223,5,244,129,373,0.615511551
40001,106,14,343,420,763,15,0,0.0,0.0,14,362,385,747,0.979030144
40001,106,14,343,420,763,15,0,0.0,1.0,14,6,749,755,0.989515072
41001,96,10,155,235,390,10,0,0.0,0.0,11,247,105,352,0.902564103
41001,96,10,155,235,390,10,0,0.0,1.0,9,205,117,322,0.825641026
41002,96,10,155,235,390,10,0,0.0,0.0,9,66,262,328,0.841025641
41002,96,10,155,235,390,10,0,0.0,1.0,12,-4,268,264,0.676923077
41003,96,10,155,235,390,10,0,0.0,0.0,9,68,250,318,0.815384615
41003,96,10,155,235,390,10,0,0.0,1.0,10,71,283,354,0.907692308
41004,96,10,155,235,390,10,0,0.0,0.0,9,-50,408,358,0.917948718
41004,96,10,155,235,390,10,0,0.0,1.0,9,128,259,387,0.992307692
41005,96,10,155,235,390,10,0,0.0,0.0,11,31,286,317,0.812820513
41005,96,10,155,235,390,10,0,0.0,1.0,8,93,184,277,0.71025641
42001,112,13,260,416,676,10,1,0.0,0.0,13,380,285,665,0.983727811
42002,112,13,260,416,676,10,1,0.0,0.0,10,298,245,543,0.803254438
42003,112,13,260,416,676,10,1,0.0,0.0,14,391,262,653,0.965976331
42004,112,13,260,416,676,10,1,0.0,0.0,13,260,371,631,0.933431953
43001,115,6,150,210,360,13,0,0.0,0.0,3,9,157,166,0.461111111
43001,115,6,150,210,360,13,0,0.0,1.0,5,202,76,278,0.772222222
43001,115,6,150,210,360,13,0,0.0,2.0,6,-36,380,344,0.955555556
43001,115,6,150,210,360,13,0,0.0,3.0,5,142,156,298,0.827777778
46001,112,19,380,614,994,14,0,0.0,2.9285715,6,288,116,404,0.406438632
47001,101,44,1195,1138,2333,31,0,2.6451614,4.483871,34,820,1265,2085,0.8936991
48001,112,13,260,416,676,10,1,0.6,3.4,13,159,491,650,0.961538462
48002,112,13,260,416,676,10,1,0.5,3.5,12,120,529,649,0.960059172
48003,112,13,260,416,676,10,1,0.3,3.7,15,285,375,660,0.976331361
48004,112,13,260,416,676,10,1,0.6,3.4,11,11,632,643,0.951183432
48005,112,13,260,416,676,10,1,0.6,3.0,12,249,403,652,0.964497041
49001,57,6,63,102,165,10,0,0.0,0.0,9,23,25,48,0.290909091
49002,57,6,63,102,165,10,0,0.0,0.0,5,145,15,160,0.96969697
49003,57,5,57,94,151,8,0,0.0,0.0,4,35,93,128,0.847682119
50001,113,27,648,999,1647,18,0,2.2777777,0.5555556,20,491,904,1395,0.846994536
50001,113,27,648,999,1647,18,0,2.2777777,1.5555556,23,374,1143,1517,0.92106861
51001,112,13,260,416,676,10,1,0.0,0.0,12,72,516,588,0.869822485
51002,112,13,260,416,676,10,1,0.0,0.0,14,307,365,672,0.99408284
51004,112,13,260,416,676,10,1,0.0,0.0,10,116,434,550,0.813609467
53001,105,23,529,529,1058,20,0,0.0,0.0,29,175,791,966,0.913043478
53002,105,23,529,529,1058,20,0,0.0,0.0,24,163,655,818,0.7731569
53003,105,23,529,529,1058,20,0,0.0,0.0,27,395,595,990,0.935727788
53004,105,23,529,529,1058,20,0,0.0,0.0,28,-492,1478,986,0.93194707
53005,105,23,529,529,1058,20,0,0.0,0.0,30,131,829,960,0.907372401
53005,105,23,529,529,1058,20,0,0.0,1.0,11,300,252,552,0.52173913
53006,105,23,529,529,1058,20,0,0.0,0.0,26,-97,1051,954,0.901701323
53007,105,23,529,529,1058,20,0,0.0,0.0,30,340,620,960,0.907372401
53008,105,23,529,529,1058,20,0,0.0,0.0,30,287,673,960,0.907372401
53008,105,23,529,529,1058,20,0,0.0,1.0,22,192,678,870,0.822306238
53009,105,23,529,529,1058,20,0,0.0,0.0,27,-326,1342,1016,0.960302457
53010,105,23,529,529,1058,20,0,0.0,0.0,28,165,817,982,0.928166352
53011,105,23,529,529,1058,20,0,0.0,0.0,28,672,326,998,0.943289225
53016,105,3,75,75,150,2,0,0.0,0.0,2,108,32,140,0.933333333
54001,262,18,8262,4716,12978,36,0,0.0,0.0,16,935,10878,11813,0.910232701
57001,112,13,260,416,676,10,1,0.0,0.0,11,142,445,587,0.868343195
57002,108,12,270,366,636,9,0,0.0,0.0,11,-224,783,559,0.878930818
60001,520,90,22590,22590,45180,18,0,0.5555556,4.388889,65,21685,15415,37100,0.821159805
63001,112,13,260,416,676,10,1,0.0,0.0,12,-5,671,666,0.985207101
63001,112,13,260,416,676,10,1,0.0,1.0,13,270,380,650,0.961538462
63002,112,13,260,416,676,10,1,0.0,0.0,13,483,185,668,0.98816568
63002,112,13,260,416,676,10,1,0.0,1.0,12,392,268,660,0.976331361
63003,112,13,260,416,676,10,1,0.0,0.0,9,45,399,444,0.656804734
63003,112,13,260,416,676,10,1,0.0,1.0,9,-245,629,384,0.568047337
63004,112,13,260,416,676,10,1,0.0,0.0,13,229,397,626,0.926035503
63004,112,13,260,416,676,10,1,0.0,1.0,10,150,382,532,0.786982249
65001,102,5,140,150,290,12,0,0.0,0.0,4,93,181,274,0.944827586
65001,102,5,140,150,290,12,0,0.0,1.0,6,160,125,285,0.982758621
65001,102,5,140,150,290,12,0,0.0,2.0,4,125,127,252,0.868965517
65001,102,5,140,150,290,12,0,0.0,3.0,5,49,221,270,0.931034483
65001,102,5,140,150,290,12,0,0.0,4.0,6,119,166,285,0.982758621
65001,102,5,140,150,290,12,0,0.0,5.0,6,142,143,285,0.982758621
65001,102,5,140,150,290,12,0,0.0,6.0,6,129,156,285,0.982758621
65001,102,5,140,150,290,12,0,0.0,7.0,5,114,176,290,1.0
65001,102,5,140,150,290,12,0,0.0,8.0,4,131,110,241,0.831034483
67001,112,9,180,288,468,6,0,0.0,2.0,8,243,216,459,0.980769231
69001,112,13,260,416,676,10,1,0.0,0.0,3,281,-30,251,0.371301775
69002,112,13,260,416,676,10,1,0.0,0.0,6,140,295,435,0.643491124
71001,110,9,162,270,432,6,0,0.0,0.0,9,117,315,432,1.0
72001,112,13,260,416,676,10,1,0.0,0.0,7,30,422,452,0.668639053
72002,112,13,260,416,676,10,1,0.0,0.0,13,571,93,664,0.982248521
72003,112,13,260,416,676,10,1,0.0,0.0,10,249,331,580,0.857988166
73001,130,128,7801,7801,15602,48,0,0.0,0.8958333,125,7939,5165,13104,0.839892321
74001,110,21,420,630,1050,15,0,0.0,0.0,19,83,907,990,0.942857143
74001,110,21,420,630,1050,15,0,0.0,1.0,19,194,817,1011,0.962857143
74002,110,21,420,630,1050,15,0,0.0,0.0,20,449,556,1005,0.957142857
74002,110,21,420,630,1050,15,0,0.0,1.0,21,295,740,1035,0.985714286
74003,110,21,420,630,1050,15,0,0.0,0.0,19,590,423,1013,0.964761905
74003,110,21,420,630,1050,15,0,0.0,1.0,20,158,869,1027,0.978095238
74004,110,21,420,630,1050,15,0,0.0,0.0,16,453,390,843,0.802857143
74004,110,21,420,630,1050,15,0,0.0,1.0,15,708,177,885,0.842857143
74005,110,21,420,630,1050,15,0,0.0,0.0,19,-45,1009,964,0.918095238
74005,110,21,420,630,1050,15,0,0.0,1.0,18,672,285,957,0.911428571
74006,110,21,420,630,1050,15,0,0.0,0.0,21,252,747,999,0.951428571
74006,110,21,420,630,1050,15,0,0.0,1.0,18,234,715,949,0.903809524
74007,110,21,420,630,1050,15,0,0.0,0.0,20,194,823,1017,0.968571429
74007,110,21,420,630,1050,15,0,0.0,1.0,19,626,342,968,0.921904762
74008,110,21,420,630,1050,15,0,0.0,0.0,18,474,499,973,0.926666667
74008,110,21,420,630,1050,15,0,0.0,1.0,19,378,627,1005,0.957142857
74009,110,21,420,630,1050,15,0,0.0,0.0,18,99,814,913,0.86952381
74009,110,21,420,630,1050,15,0,0.0,1.0,17,120,773,893,0.85047619
74010,110,21,420,630,1050,15,0,0.0,0.0,14,813,0,813,0.774285714
74010,110,21,420,630,1050,15,0,0.0,1.0,15,-233,1027,794,0.756190476
74011,110,21,420,630,1050,15,0,0.0,0.0,13,291,502,793,0.755238095
74011,110,21,420,630,1050,15,0,0.0,1.0,18,594,376,970,0.923809524
74012,110,21,420,630,1050,15,0,0.0,0.0,12,441,359,800,0.761904762
74012,110,21,420,630,1050,15,0,0.0,1.0,12,-51,794,743,0.707619048
74013,110,21,420,630,1050,15,0,0.0,0.0,14,305,482,787,0.74952381
74013,110,21,420,630,1050,15,0,0.0,1.0,16,292,594,886,0.843809524
75001,100,27,837,837,1674,18,0,0.0,0.0,22,1030,427,1457,0.87037037
76001,112,13,260,416,676,10,1,0.0,0.0,13,198,442,640,0.946745562
76002,112,13,260,416,676,10,1,0.0,0.0,12,540,123,663,0.980769231
76003,112,13,260,416,676,10,1,0.0,0.0,12,256,366,622,0.920118343
77001,112,13,260,416,676,10,1,0.0,0.0,14,216,456,672,0.99408284
78001,112,13,260,416,676,10,1,0.0,0.0,10,256,285,541,0.800295858
80001,112,13,260,416,676,10,1,0.0,0.0,13,-21,661,640,0.946745562
81001,110,13,234,390,624,10,0,0.0,0.0,11,-222,779,557,0.892628205
81002,110,13,234,390,624,10,0,0.0,0.0,13,511,101,612,0.980769231
81003,110,13,234,390,624,10,0,0.0,0.0,11,76,441,517,0.828525641
81004,110,13,234,390,624,10,0,0.0,0.0,11,96,437,533,0.854166667
81005,110,13,234,390,624,10,0,0.0,0.0,10,167,359,526,0.842948718
83001,112,13,260,416,676,10,1,0.0,0.0,13,175,467,642,0.949704142
83002,112,13,260,416,676,10,1,0.0,0.5,13,207,443,650,0.961538462
83003,112,13,260,416,676,10,1,0.0,0.0,8,-9,520,511,0.75591716
83004,112,13,260,416,676,10,1,0.0,0.0,13,379,267,646,0.955621302
85001,124,8,124,312,436,10,0,0.8,2.6,8,71,216,287,0.658256881
85001,124,8,124,312,436,10,0,0.8,3.6,9,61,293,354,0.811926606
85002,124,8,124,312,436,10,0,0.9,2.1,9,32,340,372,0.853211009
85002,124,8,124,312,436,10,0,0.9,3.1,8,-14,420,406,0.931192661
86001,100,51,1275,1275,2550,35,0,0.0,0.0,48,735,1710,2445,0.958823529
86002,101,45,1125,1170,2295,30,0,0.0,0.033333335,35,843,1081,1924,0.838344227
87001,99,50,1302,1225,2527,55,0,0.0,0.0,54,755,1451,2206,0.872971903
87001,99,50,1302,1225,2527,55,0,0.0,1.0,60,1105,1145,2250,0.890383854
87001,99,50,1302,1225,2527,55,0,0.0,2.0,55,995,1267,2262,0.895132568
87001,99,50,1302,1225,2527,55,0,0.0,3.0,54,1148,1251,2399,0.949347052
87001,99,50,1302,1225,2527,55,0,0.0,4.0,53,1334,1093,2427,0.960427384
88001,112,13,260,416,676,10,1,0.0,0.0,13,216,424,640,0.946745562
88001,112,13,260,416,676,10,1,0.0,1.0,12,330,246,576,0.852071006
88002,112,13,260,416,676,10,1,0.0,0.0,12,126,493,619,0.915680473
88002,112,13,260,416,676,10,1,0.0,1.0,12,-211,838,627,0.927514793
93001,110,13,390,390,780,10,0,0.0,0.0,13,544,196,740,0.948717949
93002,110,13,390,390,780,10,0,0.0,0.0,12,538,212,750,0.961538462
93003,110,13,390,390,780,10,0,0.0,0.0,11,398,247,645,0.826923077
93004,110,13,390,390,780,10,0,0.0,0.0,10,239,416,655,0.83974359
93005,110,13,390,390,780,10,0,0.0,0.0,9,274,396,670,0.858974359
93006,110,13,390,390,780,10,0,0.0,0.0,13,509,246,755,0.967948718
93007,110,13,390,390,780,10,0,0.0,0.0,8,321,164,485,0.621794872
93008,110,13,390,390,780,10,0,0.0,0.0,10,363,287,650,0.833333333
93009,110,13,390,390,780,10,0,0.0,0.0,9,366,259,625,0.801282051
93010,110,13,390,390,780,10,0,0.0,0.0,13,743,17,760,0.974358974
93011,110,13,390,390,780,10,0,0.0,0.0,9,399,206,605,0.775641026
93012,110,13,390,390,780,10,0,0.0,0.0,12,329,411,740,0.948717949
93013,110,13,390,390,780,10,0,0.0,0.0,12,336,339,675,0.865384615
93014,110,13,390,390,780,10,0,0.0,0.0,14,53,712,765,0.980769231
93015,110,13,390,390,780,10,0,0.0,0.0,9,412,268,680,0.871794872
93016,110,13,390,390,780,10,0,0.0,0.0,12,-47,777,730,0.935897436
93017,110,13,390,390,780,10,0,0.0,0.0,12,224,531,755,0.967948718
93018,110,13,390,390,780,10,0,0.0,0.0,11,237,453,690,0.884615385
93019,110,13,390,390,780,10,0,0.0,0.0,11,-4,734,730,0.935897436
93020,110,13,390,390,780,10,0,0.0,0.0,10,309,341,650,0.833333333
93021,110,13,390,390,780,10,0,0.0,0.0,11,341,389,730,0.935897436
93022,110,13,390,390,780,10,0,0.0,0.0,11,367,328,695,0.891025641
93023,110,13,390,390,780,10,0,0.0,0.0,13,494,256,750,0.961538462
93024,110,13,390,390,780,10,0,0.0,0.0,12,476,289,765,0.980769231
93025,110,13,390,390,780,10,0,0.0,0.0,9,495,150,645,0.826923077
93026,110,6,195,195,390,4,0,0.0,0.0,3,167,73,240,0.615384615
96001,112,13,260,416,676,10,1,0.0,0.0,14,360,312,672,0.99408284
96002,112,13,260,416,676,10,1,0.0,0.0,14,-35,702,667,0.986686391
96003,112,13,260,416,676,10,1,0.0,0.0,15,198,462,660,0.976331361
96004,112,13,260,416,676,10,1,0.0,0.0,14,163,503,666,0.985207101
96005,112,13,260,416,676,10,1,0.0,0.0,15,255,405,660,0.976331361
97001,65,13,780,390,1170,10,0,1.3,3.7,12,268,832,1100,0.94017094
97001,65,13,780,390,1170,10,0,1.3,4.7,13,449,691,1140,0.974358974
97002,65,13,780,390,1170,10,0,0.6,4.4,14,336,799,1135,0.97008547
97002,65,13,780,390,1170,10,0,0.6,5.4,10,120,825,945,0.807692308
98001,108,195,4020,5766,9786,153,0,0.0,0.0,170,1552,6373,7925,0.80983037
99001,112,13,260,416,676,10,1,0.0,0.0,9,-173,624,451,0.667159763
99001,112,13,260,416,676,10,1,0.0,1.0,13,118,489,607,0.897928994
99001,112,13,260,416,676,10,1,0.0,2.0,10,306,253,559,0.826923077
99002,112,13,260,416,676,10,1,0.0,0.0,10,28,564,592,0.875739645
99002,112,13,260,416,676,10,1,0.0,1.0,10,330,253,583,0.862426036
99002,112,13,260,416,676,10,1,0.0,2.0,12,195,370,565,0.835798817
99003,112,13,260,416,676,10,1,0.0,0.0,12,417,207,624,0.923076923
99003,112,13,260,416,676,10,1,0.0,1.0,12,502,142,644,0.952662722
99003,112,13,260,416,676,10,1,0.0,2.0,12,567,34,601,0.889053254
99005,112,13,260,416,676,10,1,0.0,0.0,12,127,480,607,0.897928994
99005,112,13,260,416,676,10,1,0.0,1.0,12,-66,724,658,0.973372781
99005,112,13,260,416,676,10,1,0.0,2.0,10,48,482,530,0.784023669
99006,112,13,260,416,676,10,1,0.0,0.0,13,238,376,614,0.908284024
99006,112,13,260,416,676,10,1,0.0,1.0,14,427,245,672,0.99408284
99006,112,13,260,416,676,10,1,0.0,2.0,14,317,335,652,0.964497041
99008,112,13,260,416,676,10,1,0.0,0.0,10,148,456,604,0.893491124
99008,112,13,260,416,676,10,1,0.0,1.0,12,323,295,618,0.914201183
99008,112,13,260,416,676,10,1,0.0,2.0,8,318,180,498,0.736686391
99009,112,13,260,416,676,10,1,0.0,0.0,11,-160,772,612,0.905325444
99009,112,13,260,416,676,10,1,0.0,1.0,14,98,564,662,0.979289941
99009,112,13,260,416,676,10,1,0.0,2.0,12,357,132,489,0.723372781
99012,97,3,114,111,225,3,0,0.0,0.0,3,-495,675,180,0.8
101007,124,15,375,585,960,10,0,0.0,0.0,13,397,515,912,0.95
102001,112,13,260,416,676,10,1,0.0,0.0,11,112,548,660,0.976331361
105001,110,21,420,630,1050,15,0,0.6666667,0.0,18,590,381,971,0.924761905
105002,110,21,420,630,1050,15,0,0.46666667,0.0,18,561,440,1001,0.953333333
105003,110,21,420,630,1050,15,0,0.46666667,0.0,18,642,332,974,0.927619048
106001,105,2,65,75,140,6,0,0.0,3.3333333,3,79,41,120,0.857142857
106001,105,2,65,75,140,6,0,0.0,4.3333335,3,115,5,120,0.857142857
106002,105,2,65,75,140,6,0,0.5,3.3333333,2,69,1,70,0.5
106002,105,2,65,75,140,6,0,0.5,4.3333335,3,70,50,120,0.857142857
106002,105,2,65,75,140,6,0,0.5,5.3333335,2,71,69,140,1.0
106003,105,2,65,75,140,6,0,0.0,4.0,3,-7,127,120,0.857142857
106003,105,2,65,75,140,6,0,0.0,5.0,3,28,92,120,0.857142857
106003,105,2,65,75,140,6,0,0.0,6.0,1,40,60,100,0.714285714
106004,105,2,65,75,140,6,0,0.0,4.0,1,20,30,50,0.357142857
106004,105,2,65,75,140,6,0,0.0,5.0,2,50,90,140,1.0
106004,105,2,65,75,140,6,0,0.0,6.0,1,7,68,75,0.535714286
106005,105,2,65,75,140,6,0,0.0,4.0,2,50,90,140,1.0
106005,105,2,65,75,140,6,0,0.0,5.0,1,35,30,65,0.464285714
106005,105,2,65,75,140,6,0,0.0,6.0,2,51,89,140,1.0
106006,105,2,65,75,140,6,0,0.0,3.3333333,2,26,44,70,0.5
106006,105,2,65,75,140,6,0,0.0,4.3333335,2,29,76,105,0.75
106006,105,2,65,75,140,6,0,0.0,5.3333335,3,67,53,120,0.857142857
106007,105,2,65,75,140,6,0,0.5,2.6666667,1,11,29,40,0.285714286
106007,105,2,65,75,140,6,0,0.5,3.6666667,2,58,82,140,1.0
106007,105,2,65,75,140,6,0,0.5,4.6666665,2,77,63,140,1.0
106008,105,2,65,75,140,6,0,0.0,4.0,1,45,20,65,0.464285714
106008,105,2,65,75,140,6,0,0.0,5.0,2,-3,143,140,1.0
106008,105,2,65,75,140,6,0,0.0,6.0,2,12,103,115,0.821428571
106009,105,2,65,75,140,6,0,0.0,2.6666667,1,37,28,65,0.464285714
106009,105,2,65,75,140,6,0,0.0,3.6666667,2,-11,126,115,0.821428571
106009,105,2,65,75,140,6,0,0.0,4.6666665,2,-5,75,70,0.5
108006,114,30,645,1050,1695,20,0,0.0,0.0,17,343,748,1091,0.643657817
108007,114,30,645,1050,1695,20,0,0.0,0.0,18,516,615,1131,0.667256637
108008,114,30,645,1050,1695,20,0,0.0,0.0,22,438,938,1376,0.81179941
108009,114,30,645,1050,1695,20,0,0.0,0.0,23,493,958,1451,0.856047198
108010,114,30,645,1050,1695,20,0,0.0,0.0,19,440,773,1213,0.715634218
108011,114,30,645,1050,1695,20,0,0.0,0.0,20,288,946,1234,0.728023599
108012,114,30,645,1050,1695,20,0,0.0,0.0,17,408,662,1070,0.631268437
108013,114,30,645,1050,1695,20,0,0.0,0.0,19,487,797,1284,0.757522124
108016,114,30,645,1050,1695,20,0,0.0,0.0,20,479,826,1305,0.769911504
108018,114,30,645,1050,1695,20,0,0.0,0.0,19,918,271,1189,0.701474926
108023,111,12,330,456,786,8,0,0.0,0.0,4,219,129,348,0.442748092
110001,105,23,529,529,1058,20,0,0.05,2.8,18,619,247,866,0.81852552
110001,105,23,529,529,1058,20,0,0.05,3.8,22,728,212,940,0.888468809
110001,105,23,529,529,1058,20,0,0.05,1.8,17,505,221,726,0.686200378
110002,96,6,198,144,342,5,0,0.4,1.2,2,137,39,176,0.514619883
110002,96,6,198,144,342,5,0,0.4,2.2,2,54,74,128,0.374269006
110002,96,6,198,144,342,5,0,0.4,3.2,3,38,100,138,0.403508772
111001,129,138,8461,8443,16904,53,0,0.0,1.7169812,150,4596,7883,12479,0.738227638
112001,112,13,260,416,676,10,1,0.0,0.0,14,285,374,659,0.974852071
113001,112,13,260,416,676,10,1,0.0,0.0,11,193,392,585,0.865384615
113001,112,13,260,416,676,10,1,0.0,1.0,13,728,-69,659,0.974852071
113001,112,13,260,416,676,10,1,0.0,2.0,11,214,416,630,0.931952663
113001,112,13,260,416,676,10,1,0.0,3.0,12,434,217,651,0.963017751
115001,112,13,260,416,676,10,1,0.0,0.0,10,193,331,524,0.775147929
115002,112,13,260,416,676,10,1,0.0,0.0,4,78,239,317,0.468934911
115003,112,13,260,416,676,10,1,0.0,0.0,9,-495,1059,564,0.834319527
115004,112,13,260,416,676,10,1,0.0,0.0,5,123,229,352,0.520710059
116001,96,10,155,235,390,10,0,0.0,0.0,8,214,153,367,0.941025641
116001,96,10,155,235,390,10,0,0.0,1.0,10,202,178,380,0.974358974
116002,96,10,155,235,390,10,0,0.0,0.0,9,201,174,375,0.961538462
116002,96,10,155,235,390,10,0,0.0,1.0,10,164,202,366,0.938461538
116003,96,10,155,235,390,10,0,0.0,0.0,8,115,212,327,0.838461538
116003,96,10,155,235,390,10,0,0.0,1.0,9,148,227,375,0.961538462
117001,262,18,8262,4716,12978,36,0,0.0,1.0,17,-110,12471,12361,0.952458006
118001,112,13,260,416,676,10,1,0.0,0.0,6,-287,722,435,0.643491124
118001,112,13,260,416,676,10,1,0.0,1.0,3,13,152,165,0.24408284
119001,65,13,780,390,1170,10,0,0.9,4.1,10,73,907,980,0.837606838
119001,65,13,780,390,1170,10,0,0.9,5.1,10,-3,1018,1015,0.867521368
119002,65,13,780,390,1170,10,0,1.5,2.0,11,293,782,1075,0.918803419
119002,65,13,780,390,1170,10,0,1.5,3.0,9,144,736,880,0.752136752
119003,65,13,780,390,1170,10,0,0.4,4.1,6,77,693,770,0.658119658
119003,65,13,780,390,1170,10,0,0.4,5.1,8,271,694,965,0.824786325
120001,78,13,312,156,468,10,0,0.4,6.6,6,-45,339,294,0.628205128
120001,78,13,312,156,468,10,0,0.4,7.6,8,-199,499,300,0.641025641
120002,78,13,312,156,468,10,0,1.2,8.8,8,34,320,354,0.756410256
120002,78,13,312,156,468,10,0,1.2,9.8,6,47,251,298,0.636752137
120003,78,13,312,156,468,10,0,1.1,6.9,6,99,219,318,0.679487179
120003,78,13,312,156,468,10,0,1.1,7.9,6,62,240,302,0.645299145
120004,78,13,312,156,468,10,0,1.1,6.4,11,8,436,444,0.948717949
120004,78,13,312,156,468,10,0,1.1,7.4,9,-46,430,384,0.820512821
122001,115,27,594,999,1593,18,0,1.6666666,0.0,24,288,1181,1469,0.922159448
124001,65,13,780,390,1170,10,0,0.0,2.9,9,454,576,1030,0.88034188
124001,65,13,780,390,1170,10,0,0.0,3.9,10,335,725,1060,0.905982906
124002,65,13,780,390,1170,10,0,1.4,2.3,9,290,675,965,0.824786325
124002,65,13,780,390,1170,10,0,1.4,3.3,5,167,473,640,0.547008547
124003,65,13,780,390,1170,10,0,0.6,2.3,9,502,528,1030,0.88034188
124003,65,13,780,390,1170,10,0,0.6,3.3,9,339,641,980,0.837606838
125001,123,9,135,207,342,10,0,0.0,0.0,7,-31,318,287,0.839181287
125001,123,9,135,207,342,10,0,0.0,1.0,9,122,170,292,0.85380117
125001,123,9,135,207,342,10,0,0.0,2.0,10,299,2,301,0.880116959
125002,123,9,135,207,342,10,0,0.0,0.0,6,139,144,283,0.82748538
125002,123,9,135,207,342,10,0,0.0,1.0,8,184,98,282,0.824561404
125002,123,9,135,207,342,10,0,0.0,2.0,8,227,61,288,0.842105263
126001,500,32,8064,8064,16128,40,0,0.0,3.875,27,774,12210,13304,0.824900794
126002,500,32,8064,8064,16128,40,0,0.0,3.575,27,1751,12113,13864,0.859623016
126003,500,32,8064,8064,16128,40,0,0.0,3.575,30,-2320,14224,11904,0.738095238
126004,500,32,8064,8064,16128,40,0,0.0,3.45,28,1359,11233,12592,0.780753968
126005,500,32,8064,8064,16128,40,0,0.0,3.7,25,2165,10771,12936,0.802083333
126006,492,28,7408,7200,14608,33,0,0.0,3.4848485,16,3024,5904,8928,0.611171961
127001,135,5,45,95,140,10,0,0.0,0.0,7,30,21,51,0.364285714
127002,135,5,45,95,140,10,0,0.0,0.0,10,73,-125,-52,-0.371428571
127003,125,3,57,51,108,5,0,0.0,0.0,4,61,31,92,0.851851852
129001,112,13,260,416,676,10,1,0.2,6.8,12,197,352,549,0.812130178
129002,112,13,260,416,676,10,1,0.4,6.5,12,222,377,599,0.886094675
129003,112,13,260,416,676,10,1,1.0,5.1,13,135,518,653,0.965976331
129004,112,9,180,288,468,6,0,0.0,5.5,9,236,232,468,1.0
130001,112,13,260,416,676,10,1,0.0,0.8,9,469,-1,468,0.692307692
130002,112,13,260,416,676,10,1,0.1,0.8,10,352,261,613,0.906804734
130003,112,13,260,416,676,10,1,0.0,1.0,10,358,216,574,0.849112426
130004,112,13,260,416,676,10,1,0.1,0.9,7,438,30,468,0.692307692
130005,112,13,260,416,676,10,1,0.1,0.8,9,420,165,585,0.865384615
131001,112,13,260,416,676,10,1,0.0,2.0,11,219,340,559,0.826923077
131001,112,13,260,416,676,10,1,0.0,3.0,7,138,225,363,0.536982249
131002,112,13,260,416,676,10,1,0.2,1.8,7,-8,471,463,0.684911243
131002,112,13,260,416,676,10,1,0.2,2.8,6,17,413,430,0.636094675
131003,112,13,260,416,676,10,1,0.1,1.8,10,184,396,580,0.857988166
131003,112,13,260,416,676,10,1,0.1,2.8,10,182,366,548,0.810650888
131004,112,13,260,416,676,10,1,0.2,1.8,14,205,459,664,0.982248521
131004,112,13,260,416,676,10,1,0.2,2.8,12,224,425,649,0.960059172
131005,112,13,260,416,676,10,1,0.0,2.0,11,119,530,649,0.960059172
131005,112,13,260,416,676,10,1,0.0,3.0,11,170,473,643,0.951183432
133001,112,13,260,416,676,10,1,0.2,0.8,11,141,457,598,0.884615385
133001,112,13,260,416,676,10,1,0.2,1.8,10,220,351,571,0.844674556
133002,112,13,260,416,676,10,1,0.1,0.9,10,320,252,572,0.846153846
133002,112,13,260,416,676,10,1,0.1,1.9,12,399,170,569,0.841715976
133003,112,13,260,416,676,10,1,0.2,0.8,9,311,191,502,0.74260355
133003,112,13,260,416,676,10,1,0.2,1.8,10,454,112,566,0.837278107
137001,111,12,336,468,804,25,0,0.0,0.0,10,359,293,652,0.810945274
138001,104,67,1606,2199,3805,48,0,0.020833334,0.0,67,427,3259,3686,0.968725361
140001,112,13,260,416,676,10,1,0.0,0.0,14,305,338,643,0.951183432
140002,112,9,180,288,468,6,0,0.0,0.0,6,86,280,366,0.782051282
142001,112,13,260,416,676,10,1,0.0,1.0,14,510,156,666,0.985207101
142002,112,13,260,416,676,10,1,0.0,1.0,12,348,277,625,0.924556213
142003,112,11,223,357,580,8,0,0.0,1.0,8,339,121,460,0.793103448
144001,100,25,650,650,1300,50,0,0.0,0.42,19,549,497,1046,0.804615385
144001,100,25,650,650,1300,50,0,0.0,1.42,20,322,796,1118,0.86
144001,100,25,650,650,1300,50,0,0.0,2.42,19,161,881,1042,0.801538462
144002,100,25,650,650,1300,50,0,0.0,0.08,21,428,670,1098,0.844615385
144002,100,25,650,650,1300,50,0,0.0,1.08,20,371,669,1040,0.8
144002,100,25,650,650,1300,50,0,0.0,2.08,23,491,749,1240,0.953846154
144003,100,25,650,650,1300,50,0,0.08,0.34,22,394,776,1170,0.9
144003,100,25,650,650,1300,50,0,0.08,1.34,21,409,673,1082,0.832307692
144003,100,25,650,650,1300,50,0,0.08,2.34,21,366,748,1114,0.856923077
144004,100,18,594,594,1188,37,0,0.0,0.21621622,17,523,583,1106,0.930976431
144004,100,18,594,594,1188,37,0,0.0,1.2162162,12,93,715,808,0.68013468
144004,100,18,594,594,1188,37,0,0.0,2.2162163,16,472,628,1100,0.925925926
145001,97,7,206,185,391,15,0,0.0,0.0,7,249,118,367,0.938618926
146001,99,89,4407,4317,8724,179,0,0.0,0.0,73,5772,1330,7102,0.814076112
146001,99,89,4407,4317,8724,179,0,0.0,1.0,52,-3404,8414,5122,0.587116002
146001,99,89,4407,4317,8724,179,0,0.0,2.0,57,392,5062,5454,0.625171939
148001,112,13,260,416,676,10,1,0.0,1.6,12,298,338,636,0.940828402
148002,112,13,260,416,676,10,1,0.0,2.0,12,253,419,672,0.99408284
148003,112,13,260,416,676,10,1,0.0,2.0,14,12,634,646,0.955621302
148004,112,13,260,416,676,10,1,0.0,1.9,9,491,19,510,0.75443787
148005,112,13,260,416,676,10,1,0.0,1.9,12,350,312,662,0.979289941
148006,112,13,260,416,676,10,1,0.0,1.8,13,-148,772,624,0.923076923
150001,112,13,260,416,676,10,1,0.0,0.0,9,-19,523,504,0.74556213
150001,112,13,260,416,676,10,1,0.0,1.0,13,-5,625,620,0.917159763
150001,112,13,260,416,676,10,1,0.0,2.0,11,158,480,638,0.943786982
150002,112,13,260,416,676,10,1,0.0,0.0,13,625,12,637,0.942307692
150002,112,13,260,416,676,10,1,0.0,1.0,8,332,52,384,0.568047337
150002,112,13,260,416,676,10,1,0.0,2.0,12,159,378,537,0.794378698
150003,112,13,260,416,676,10,1,0.0,0.0,10,-48,560,512,0.75739645
150003,112,13,260,416,676,10,1,0.0,1.0,12,-19,635,616,0.911242604
150003,112,13,260,416,676,10,1,0.0,2.0,12,4,613,617,0.912721893
150004,112,13,260,416,676,10,1,0.0,0.0,7,412,55,467,0.690828402
150004,112,13,260,416,676,10,1,0.0,1.0,10,356,242,598,0.884615385
150004,112,13,260,416,676,10,1,0.0,2.0,10,252,278,530,0.784023669
150005,107,9,225,303,528,7,0,0.0,0.0,8,409,45,454,0.859848485
150005,112,13,260,416,676,10,1,0.0,0.7,12,604,29,633,0.936390533
150005,112,13,260,416,676,10,1,0.0,1.7,9,10,414,424,0.627218935
151001,100,11,354,395,749,8,0,0.0,0.5,4,290,-18,272,0.363150868
151001,100,14,439,499,938,10,0,0.0,1.2,10,173,496,669,0.713219616
151002,100,5,175,178,353,4,0,0.0,0.0,1,-50,150,100,0.283286119
151002,100,5,175,178,353,4,0,0.0,1.0,4,-165,489,324,0.917847025
155001,112,13,260,416,676,10,1,0.1,1.9,6,-83,483,400,0.591715976
155001,112,13,260,416,676,10,1,0.1,2.9,9,164,376,540,0.798816568
155001,112,13,260,416,676,10,1,0.1,3.9,1,28,60,88,0.130177515
155002,112,13,260,416,676,10,1,0.1,1.9,9,-199,722,523,0.773668639
155002,112,13,260,416,676,10,1,0.1,2.9,10,-62,609,547,0.809171598
155002,112,13,260,416,676,10,1,0.1,3.9,1,4,80,84,0.124260355
155003,110,3,75,105,180,2,0,0.0,2.0,2,128,32,160,0.888888889
155003,110,3,75,105,180,2,0,0.0,3.0,3,240,-60,180,1.0
156001,104,55,1450,1485,2935,40,0,0.0,0.175,30,1641,189,1830,0.62350937
156001,104,55,1450,1485,2935,40,0,0.0,1.175,41,1229,1068,2297,0.782623509
156001,104,55,1450,1485,2935,40,0,0.0,2.175,36,604,1421,2025,0.689948893
156003,104,55,1450,1485,2935,40,0,0.0,0.075,34,1656,418,2074,0.706643952
156003,104,55,1450,1485,2935,40,0,0.0,1.075,38,1502,701,2203,0.750596252
156003,104,55,1450,1485,2935,40,0,0.0,2.075,33,436,1417,1858,0.633049404
156004,104,55,1450,1485,2935,40,0,0.0,0.15,32,-465,2313,1848,0.629642249
156004,104,55,1450,1485,2935,40,0,0.0,1.15,27,-124,1739,1615,0.550255537
156004,104,55,1450,1485,2935,40,0,0.0,2.15,40,342,1866,2208,0.75229983
156005,104,55,1450,1485,2935,40,0,0.0,0.075,21,1184,235,1419,0.483475298
156005,104,55,1450,1485,2935,40,0,0.0,1.075,37,1946,146,2092,0.712776831
156005,104,55,1450,1485,2935,40,0,0.0,2.075,36,1712,315,2048,0.697785349
156006,104,55,1450,1485,2935,40,0,0.0,0.0,36,2152,-73,2079,0.70834753
156006,104,55,1450,1485,2935,40,0,0.0,1.0,42,2322,118,2440,0.831345826
156006,104,55,1450,1485,2935,40,0,0.0,2.0,38,2309,-120,2189,0.745826235
156007,104,55,1450,1485,2935,40,0,0.0,0.0,17,411,793,1204,0.410221465
156007,104,55,1450,1485,2935,40,0,0.0,1.0,41,402,1756,2158,0.735264055
156007,104,55,1450,1485,2935,40,0,0.0,2.0,34,-227,2113,1886,0.642589438
156008,99,33,858,849,1707,23,0,0.0,0.0,13,663,164,827,0.484475688
156008,99,33,858,849,1707,23,0,0.0,1.0,23,1109,175,1284,0.752196837
156009,100,15,420,420,840,10,0,0.0,0.0,8,431,161,592,0.704761905
158001,96,10,155,235,390,10,0,0.0,4.0,12,196,165,361,0.925641026
158001,96,10,155,235,390,10,0,0.0,5.0,10,140,240,380,0.974358974
158002,96,10,155,235,390,10,0,0.0,4.0,11,200,110,310,0.794871795
158002,96,10,155,235,390,10,0,0.0,5.0,10,163,166,329,0.843589744
158003,96,10,155,235,390,10,0,0.0,4.0,10,136,212,348,0.892307692
158003,96,10,155,235,390,10,0,0.0,5.0,10,169,198,367,0.941025641
159001,107,18,396,522,918,13,0,0.0,0.0,6,-213,617,404,0.440087146
160001,149,30,1095,1095,2190,20,0,0.0,0.0,29,971,1168,2139,0.976712329
160002,144,3,138,127,265,3,0,0.0,0.0,3,226,38,264,0.996226415
161001,675,11,1395,1395,2790,36,0,0.0,2.0,15,1958,-23,1935,0.693548387
162001,129,117,7101,7143,14244,43,0,0.0,2.7441862,101,4204,6131,10335,0.72556866
163001,112,13,260,416,676,10,1,0.0,0.0,5,254,43,297,0.439349112
163002,112,13,260,416,676,10,1,0.0,0.0,9,84,383,467,0.690828402
164001,78,13,312,156,468,10,0,1.2,6.0,9,-191,539,348,0.743589744
164001,78,13,312,156,468,10,0,1.2,7.0,11,-194,616,422,0.901709402
164002,78,13,312,156,468,10,0,0.1,8.9,4,137,85,222,0.474358974
164002,78,13,312,156,468,10,0,0.1,9.9,5,45,151,196,0.418803419
164003,78,13,312,156,468,10,0,0.5,7.1,7,15,331,346,0.739316239
164003,78,13,312,156,468,10,0,0.5,8.1,4,38,192,230,0.491452991
164004,78,13,312,156,468,10,0,1.1,6.4,9,107,281,388,0.829059829
164004,78,13,312,156,468,10,0,1.1,7.4,7,-81,369,288,0.615384615
164005,78,13,312,156,468,10,0,1.4,7.3,9,120,256,376,0.803418803
164005,78,13,312,156,468,10,0,1.4,8.3,9,-1,375,374,0.799145299
167001,112,13,260,416,676,10,1,0.0,0.0,13,324,296,620,0.917159763
167001,112,13,260,416,676,10,1,0.0,1.0,14,59,589,648,0.958579882
167001,112,13,260,416,676,10,1,0.0,2.0,14,333,336,669,0.98964497
167001,112,13,260,416,676,10,1,0.0,3.0,14,288,372,660,0.976331361
167002,112,13,260,416,676,10,1,0.0,0.0,14,115,546,661,0.977810651
167002,112,13,260,416,676,10,1,0.0,1.0,13,382,266,648,0.958579882
167002,112,13,260,416,676,10,1,0.0,2.0,15,142,518,660,0.976331361
167002,112,13,260,416,676,10,1,0.0,3.0,15,450,210,660,0.976331361
167003,112,13,260,416,676,10,1,0.0,0.0,14,470,199,669,0.98964497
167003,112,13,260,416,676,10,1,0.0,1.0,13,305,356,661,0.977810651
167003,112,13,260,416,676,10,1,0.0,2.0,14,285,376,661,0.977810651
167003,112,13,260,416,676,10,1,0.0,3.0,14,346,326,672,0.99408284
170001,112,13,260,416,676,10,1,0.0,0.0,12,390,204,594,0.878698225
170001,112,13,260,416,676,10,1,0.0,1.0,13,485,146,631,0.933431953
170001,112,13,260,416,676,10,1,0.0,2.0,13,216,457,673,0.99556213
170002,112,13,260,416,676,10,1,0.0,0.0,14,217,439,656,0.970414201
170002,112,13,260,416,676,10,1,0.0,1.0,14,493,163,656,0.970414201
170002,112,13,260,416,676,10,1,0.0,2.0,14,452,204,656,0.970414201
170003,112,13,260,416,676,10,1,0.0,0.0,15,20,640,660,0.976331361
170003,112,13,260,416,676,10,1,0.0,1.0,14,375,273,648,0.958579882
170003,112,13,260,416,676,10,1,0.0,2.0,12,309,255,564,0.834319527
170004,112,13,260,416,676,10,1,0.0,0.0,13,437,209,646,0.955621302
170004,112,13,260,416,676,10,1,0.0,1.0,13,488,138,626,0.926035503
170004,112,13,260,416,676,10,1,0.0,2.0,14,426,238,664,0.982248521
170005,112,13,260,416,676,10,1,0.0,0.0,11,427,182,609,0.900887574
170005,112,13,260,416,676,10,1,0.0,1.0,13,461,181,642,0.949704142
170005,112,13,260,416,676,10,1,0.0,2.0,14,556,110,666,0.985207101
170006,112,13,260,416,676,10,1,0.0,0.2,12,-124,750,626,0.926035503
170006,112,13,260,416,676,10,1,0.0,1.2,8,4,512,516,0.763313609
170006,112,13,260,416,676,10,1,0.0,2.2,12,91,533,624,0.923076923
170007,112,13,260,416,676,10,1,0.0,0.0,13,-143,819,676,1.0
170007,112,13,260,416,676,10,1,0.0,1.0,13,-187,821,634,0.937869822
170007,112,13,260,416,676,10,1,0.0,2.0,15,-334,994,660,0.976331361
170008,112,13,260,416,676,10,1,0.0,0.2,13,406,231,637,0.942307692
170008,112,13,260,416,676,10,1,0.0,1.2,13,413,209,622,0.920118343
170008,112,13,260,416,676,10,1,0.0,2.2,12,291,342,633,0.936390533
170009,112,13,260,416,676,10,1,0.0,0.0,12,11,595,606,0.896449704
170009,112,13,260,416,676,10,1,0.0,1.0,14,225,425,650,0.961538462
170009,112,13,260,416,676,10,1,0.0,2.0,13,342,301,643,0.951183432
170011,112,13,260,416,676,10,1,0.0,0.0,12,16,600,616,0.911242604
170011,112,13,260,416,676,10,1,0.0,1.0,10,64,530,594,0.878698225
170011,112,13,260,416,676,10,1,0.0,2.0,12,137,489,626,0.926035503
171001,107,4,100,126,226,10,0,0.0,8.9,4,-1,215,214,0.946902655
171001,107,4,100,126,226,10,0,0.0,9.9,4,-10,224,214,0.946902655
171002,102,2,84,87,171,5,0,0.0,6.8,2,38,116,154,0.900584795
171002,102,2,84,87,171,5,0,0.0,7.8,2,35,136,171,1.0
172001,112,13,260,416,676,10,1,0.0,2.1,7,132,330,462,0.683431953
172002,112,13,260,416,676,10,1,0.0,2.1,12,235,369,604,0.893491124
173001,112,13,260,416,676,10,1,0.0,0.0,13,152,524,676,1.0
173002,112,13,260,416,676,10,1,0.0,0.0,11,190,444,634,0.937869822
173003,112,13,260,416,676,10,1,0.0,0.0,11,227,338,565,0.835798817
175001,100,8,204,204,408,10,0,0.4,0.4,10,66,185,251,0.615196078
175002,100,8,204,204,408,10,0,0.4,0.5,13,-33,241,208,0.509803922
176001,112,13,260,416,676,10,1,0.0,0.0,9,105,448,553,0.818047337
176001,112,13,260,416,676,10,1,0.0,1.0,11,300,340,640,0.946745562
176002,112,13,260,416,676,10,1,0.0,0.0,11,60,555,615,0.909763314
176002,112,13,260,416,676,10,1,0.0,1.0,13,366,251,617,0.912721893
176003,112,13,260,416,676,10,1,0.0,0.0,10,292,291,583,0.862426036
176003,112,13,260,416,676,10,1,0.0,1.0,10,190,366,556,0.822485207
176004,112,13,260,416,676,10,1,0.0,0.0,13,250,399,649,0.960059172
176004,112,13,260,416,676,10,1,0.0,1.0,9,323,275,598,0.884615385
177001,112,13,260,416,676,10,1,0.0,1.0,13,287,386,673,0.99556213
177001,112,13,260,416,676,10,1,0.0,2.0,13,307,354,661,0.977810651
177002,112,13,260,416,676,10,1,0.0,1.0,14,-71,738,667,0.986686391
177002,112,13,260,416,676,10,1,0.0,2.0,12,269,331,600,0.887573964
177003,112,13,260,416,676,10,1,0.0,1.0,14,322,350,672,0.99408284
177003,112,13,260,416,676,10,1,0.0,2.0,13,124,546,670,0.99112426
177004,112,13,260,416,676,10,1,0.0,1.0,15,88,572,660,0.976331361
177004,112,13,260,416,676,10,1,0.0,2.0,15,203,457,660,0.976331361
178001,96,10,155,235,390,10,0,0.0,1.0,11,65,290,355,0.91025641
178001,96,10,155,235,390,10,0,0.0,2.0,10,19,309,328,0.841025641
178002,96,10,155,235,390,10,0,0.1,0.9,10,115,255,370,0.948717949
178002,96,10,155,235,390,10,0,0.1,1.9,10,140,247,387,0.992307692
178003,96,10,155,235,390,10,0,0.2,0.8,8,166,186,352,0.902564103
178003,96,10,155,235,390,10,0,0.2,1.8,8,150,190,340,0.871794872
178004,96,10,155,235,390,10,0,0.4,0.5,8,82,237,319,0.817948718
178004,96,10,155,235,390,10,0,0.4,1.5,10,128,247,375,0.961538462
179001,103,48,1281,1281,2562,34,0,2.764706,1.6764706,47,1362,1161,2523,0.984777518
180001,101,52,1369,1326,2695,37,0,0.0,0.0,50,1397,1192,2589,0.960667904
181001,120,16,240,360,600,39,0,0.0,0.0,18,476,91,567,0.945
184001,100,25,650,650,1300,10,0,0.0,0.0,19,363,765,1128,0.867692308
184002,100,25,650,650,1300,10,0,0.0,0.0,21,90,1136,1226,0.943076923
184003,100,25,650,650,1300,10,0,0.0,0.0,20,567,535,1102,0.847692308
185001,110,11,220,330,550,8,0,0.0,0.0,12,-83,623,540,0.981818182
186001,100,50,1275,1275,2550,20,0,0.0,0.0,35,803,1306,2109,0.827058824
186002,100,50,1275,1275,2550,20,0,0.0,0.0,25,12,1580,1592,0.624313725
186003,100,50,1275,1275,2550,20,0,0.0,0.0,44,416,1965,2381,0.93372549
186004,100,50,1275,1275,2550,20,0,0.0,0.0,27,1261,522,1783,0.699215686
186005,100,50,1275,1275,2550,20,0,0.0,0.0,35,77,2063,2140,0.839215686
186006,100,50,1275,1275,2550,20,0,0.0,0.0,16,-456,1694,1238,0.485490196
186007,100,50,1275,1275,2550,20,0,0.0,0.0,35,1401,728,2129,0.834901961
186008,100,50,1275,1275,2550,20,0,0.0,0.0,39,-731,2993,2262,0.887058824
186009,100,50,1275,1275,2550,20,0,0.0,0.0,25,379,1290,1669,0.654509804
186010,100,50,1275,1275,2550,20,0,0.0,0.0,35,1296,867,2163,0.848235294
186014,95,20,670,560,1230,9,0,0.0,0.0,6,83,441,524,0.42601626
187001,65,13,780,390,1170,10,0,0.4,3.2,13,167,883,1050,0.897435897
190001,100,27,837,837,1674,18,0,0.0,0.0,27,827,847,1674,1.0
192001,112,13,260,416,676,10,1,0.0,0.0,15,86,574,660,0.976331361
192002,112,13,260,416,676,10,1,0.0,0.0,15,168,492,660,0.976331361
194001,50,7,182,182,364,20,0,0.0,0.0,7,-117,337,220,0.604395604
196001,137,36,2484,2448,4932,18,0,0.0,0.0,34,3308,1417,4725,0.958029197
197001,550,15,3750,3750,7500,20,0,0.0,0.15,22,6305,-5605,700,0.093333333
197002,550,15,3750,3750,7500,20,0,0.0,0.0,17,-478,2078,1600,0.213333333
197003,550,15,3750,3750,7500,20,0,0.0,0.0,25,4654,-2354,2300,0.306666667
197004,550,15,3750,3750,7500,20,0,0.0,0.0,14,4032,268,4300,0.573333333
197005,550,15,3750,3750,7500,20,0,0.0,0.0,27,-759,1359,600,0.08
197006,550,15,3750,3750,7500,20,0,0.0,0.0,20,-984,3584,2600,0.346666667
197007,550,15,3750,3750,7500,20,0,0.0,0.0,17,3201,-1301,1900,0.253333333
197008,550,15,3750,3750,7500,20,0,0.0,0.15,23,3253,-1353,1900,0.253333333
197009,550,15,3750,3750,7500,20,0,0.0,0.0,24,2336,-636,1700,0.226666667
197010,550,15,3750,3750,7500,20,0,0.0,0.0,20,-1469,2569,1100,0.146666667
197011,550,15,3750,3750,7500,20,0,0.0,0.15,17,3724,776,4500,0.6
197012,550,15,3750,3750,7500,16,0,0.0,0.0,11,3499,1801,5300,0.706666667
198001,65,13,780,390,1170,10,0,0.0,2.7,6,157,598,755,0.645299145
198001,65,13,780,390,1170,10,0,0.0,3.7,8,78,752,830,0.709401709
198002,65,13,780,390,1170,10,0,0.0,2.4,8,260,640,900,0.769230769
198002,65,13,780,390,1170,10,0,0.0,3.4,6,211,624,835,0.713675214
198003,65,13,780,390,1170,10,0,0.0,2.6,10,113,982,1095,0.935897436
198003,65,13,780,390,1170,10,0,0.0,3.6,11,101,1029,1130,0.965811966
198004,65,13,780,390,1170,10,0,0.0,3.0,6,146,669,815,0.696581197
198004,65,13,780,390,1170,10,0,0.0,4.0,9,186,744,930,0.794871795
198005,65,13,780,390,1170,10,0,0.2,2.3,7,-322,1187,865,0.739316239
198005,65,13,780,390,1170,10,0,0.2,3.3,7,-288,1098,810,0.692307692
198006,57,3,234,126,360,3,0,0.0,3.0,1,75,105,180,0.5
198006,57,3,234,126,360,3,0,0.0,4.0,1,76,104,180,0.5
199001,128,27,702,1053,1755,12,0,0.0,0.0,22,738,782,1520,0.866096866
200001,112,13,260,416,676,10,1,0.0,0.0,7,315,109,424,0.627218935
200002,112,13,260,416,676,10,1,0.0,0.0,13,400,271,671,0.99260355
200003,112,13,260,416,676,10,1,0.0,0.0,11,346,235,581,0.859467456
200004,112,13,260,416,676,10,1,0.1,0.8,9,32,547,579,0.856508876
200005,112,13,260,416,676,10,1,0.0,0.0,13,187,469,656,0.970414201
201001,112,13,260,416,676,10,1,0.0,0.0,12,331,319,650,0.961538462
201001,112,13,260,416,676,10,1,0.0,1.0,13,289,381,670,0.99112426
201002,112,13,260,416,676,10,1,0.0,0.0,12,281,366,647,0.957100592
201002,112,13,260,416,676,10,1,0.0,1.0,10,265,292,557,0.823964497
202001,115,6,150,210,360,13,0,0.0,4.0,6,72,240,312,0.866666667
202001,115,6,150,210,360,13,0,0.0,5.0,5,42,208,250,0.694444444
202001,115,6,150,210,360,13,0,0.0,6.0,6,119,241,360,1.0
202001,115,6,150,210,360,13,0,0.0,7.0,6,211,141,352,0.977777778
203001,112,13,260,416,676,10,1,0.0,0.0,14,-371,1032,661,0.977810651
203002,112,13,260,416,676,10,1,0.0,0.0,12,-479,1001,522,0.772189349
203003,112,13,260,416,676,10,1,0.0,0.0,11,497,95,592,0.875739645
203004,112,13,260,416,676,10,1,0.0,0.0,15,537,123,660,0.976331361
203005,112,13,260,416,676,10,1,0.0,0.0,14,135,532,667,0.986686391
203006,112,13,260,416,676,10,1,0.0,0.0,14,-193,856,663,0.980769231
203007,112,13,260,416,676,10,1,0.0,0.0,12,147,437,584,0.863905325
203008,112,13,260,416,676,10,1,0.0,0.0,15,133,527,660,0.976331361
203009,112,13,260,416,676,10,1,0.0,0.0,15,-340,1000,660,0.976331361
203010,112,13,260,416,676,10,1,0.0,0.0,15,279,381,660,0.976331361
203011,101,6,195,201,396,5,0,0.0,0.0,6,161,145,306,0.772727273
203012,112,9,180,288,468,6,0,0.0,0.0,9,348,120,468,1.0
203013,110,3,75,105,180,2,0,0.0,0.0,3,100,80,180,1.0
203017,97,3,114,111,225,3,0,0.0,0.0,3,47,173,220,0.977777778
205001,520,70,17640,17640,35280,14,0,1.4285715,5.428571,42,18121,8188,26309,0.745719955
206001,99,6,180,174,354,5,0,0.0,1.8,6,241,105,346,0.97740113
206001,107,8,176,232,408,6,0,0.0,2.3333333,5,182,140,322,0.789215686
206001,107,8,176,232,408,6,0,0.0,3.3333333,8,157,231,388,0.950980392
206001,107,8,176,232,408,6,0,0.0,4.3333335,8,109,299,408,1.0
206001,107,8,176,232,408,6,0,0.0,5.3333335,6,122,252,374,0.916666667
207001,113,27,648,999,1647,18,0,2.2777777,2.5555556,22,774,641,1415,0.859137826
207001,113,27,648,999,1647,18,0,2.2777777,3.5555556,20,926,467,1393,0.845780206
208002,112,13,260,416,676,10,1,0.0,0.0,12,-726,1269,543,0.803254438
208003,112,13,260,416,676,10,1,0.0,0.0,12,220,284,504,0.74556213
210001,112,13,260,416,676,10,1,0.0,0.0,14,303,366,669,0.98964497
210002,112,13,260,416,676,10,1,0.0,0.0,12,282,357,639,0.945266272
210003,101,6,195,201,396,5,0,0.0,0.0,3,106,114,220,0.555555556
211001,112,13,260,416,676,10,1,0.1,0.0,13,163,460,623,0.921597633
211002,112,13,260,416,676,10,1,0.0,0.5,12,542,83,625,0.924556213
211003,112,13,260,416,676,10,1,0.0,0.0,12,11,592,603,0.892011834
211004,112,13,260,416,676,10,1,0.0,0.0,13,-12,640,628,0.928994083
211005,112,13,260,416,676,10,1,0.0,0.0,7,-52,561,509,0.75295858
216001,114,30,645,1050,1695,30,0,0.0,0.0,21,749,443,1192,0.703244838
216002,114,30,645,1050,1695,30,0,0.0,0.0,18,423,619,1042,0.614749263
216003,114,30,645,1050,1695,30,0,0.0,0.0,24,588,780,1368,0.807079646
216004,114,30,645,1050,1695,30,0,0.0,0.0,22,561,698,1259,0.742772861
216005,114,30,645,1050,1695,30,0,0.0,0.0,23,558,729,1287,0.759292035
216006,114,30,645,1050,1695,30,0,0.0,0.0,30,804,891,1695,1.0
216007,114,30,645,1050,1695,30,0,0.0,0.0,26,391,1150,1541,0.909144543
217001,94,39,1080,978,2058,78,0,0.0,0.0,28,885,578,1463,0.710884354
218001,112,13,260,416,676,10,1,0.0,0.0,12,288,366,654,0.967455621
218002,112,13,260,416,676,10,1,0.0,0.0,13,235,422,657,0.971893491
218003,108,12,270,366,636,9,0,0.0,0.0,8,241,272,513,0.806603774
220001,103,25,725,725,1450,10,0,0.3,0.3,24,856,578,1434,0.988965517
220001,103,25,725,725,1450,10,0,0.3,1.3,24,703,729,1432,0.987586207
220001,103,25,725,725,1450,10,0,0.3,2.3,24,904,528,1432,0.987586207
220002,103,25,725,725,1450,10,0,0.0,0.0,21,744,564,1308,0.902068966
220002,103,25,725,725,1450,10,0,0.0,1.0,19,385,811,1196,0.824827586
220002,103,25,725,725,1450,10,0,0.0,2.0,20,743,477,1220,0.84137931
220003,103,25,725,725,1450,10,0,0.0,0.6,23,998,410,1408,0.971034483
220003,103,25,725,725,1450,10,0,0.0,1.6,23,437,977,1414,0.975172414
220003,103,25,725,725,1450,10,0,0.0,2.6,20,869,385,1254,0.864827586
220004,103,20,600,600,1200,8,0,0.0,0.25,16,651,397,1048,0.873333333
220004,103,20,600,600,1200,8,0,0.0,1.25,17,626,488,1114,0.928333333
220004,103,20,600,600,1200,8,0,0.0,2.25,19,531,649,1180,0.983333333
222001,97,45,2121,1083,3204,32,0,0.0,0.03125,39,1113,1795,2908,0.907615481
224001,116,17,306,578,884,12,0,0.0,0.0,15,623,207,830,0.938914027
224002,116,17,306,578,884,12,0,0.0,0.0,13,580,166,746,0.843891403
225001,112,13,260,416,676,10,1,0.5,2.5,13,102,524,626,0.926035503
225002,112,13,260,416,676,10,1,0.5,2.5,12,426,224,650,0.961538462
225003,112,13,260,416,676,10,1,0.0,3.0,15,272,388,660,0.976331361
226001,112,13,260,416,676,10,1,0.0,0.0,11,237,360,597,0.883136095
226002,112,13,260,416,676,10,1,0.0,0.0,12,223,414,637,0.942307692
228001,100,25,650,650,1300,50,0,0.0,0.32,21,439,729,1168,0.898461538
228001,100,25,650,650,1300,50,0,0.0,1.32,20,390,650,1040,0.8
228001,100,25,650,650,1300,50,0,0.0,2.32,22,454,736,1190,0.915384615
228002,100,25,650,650,1300,50,0,0.0,0.08,23,500,744,1244,0.956923077
228002,100,25,650,650,1300,50,0,0.0,1.08,23,592,652,1244,0.956923077
228002,100,25,650,650,1300,50,0,0.0,2.08,21,560,596,1156,0.889230769
228003,100,25,650,650,1300,50,0,0.0,0.64,19,454,508,962,0.74
228003,100,25,650,650,1300,50,0,0.0,1.64,19,477,523,1000,0.769230769
228003,100,25,650,650,1300,50,0,0.0,2.64,24,605,663,1268,0.975384615
229001,96,10,155,235,390,10,0,0.7,2.3,7,109,158,267,0.684615385
229001,96,10,155,235,390,10,0,0.7,3.3,8,112,240,352,0.902564103
229002,96,10,155,235,390,10,0,0.7,2.3,13,271,68,339,0.869230769
229002,96,10,155,235,390,10,0,0.7,3.3,11,206,169,375,0.961538462
229003,96,10,155,235,390,10,0,0.1,2.9,12,150,201,351,0.9
229003,96,10,155,235,390,10,0,0.1,3.9,11,152,209,361,0.925641026
230001,72,16,648,517,1165,32,0,0.0,0.875,15,377,712,1089,0.934763948
232001,99,12,414,432,846,9,0,0.6666667,0.0,8,561,80,641,0.757683215
232001,99,15,510,522,1032,11,0,2.1818182,2.4545455,13,540,376,916,0.887596899
233001,110,21,420,630,1050,15,0,0.0,0.0,21,539,499,1038,0.988571429
234001,112,13,260,416,676,10,1,0.3,1.6,11,116,497,613,0.906804734
234002,112,13,260,416,676,10,1,0.4,1.6,5,98,287,385,0.569526627
234003,112,13,260,416,676,10,1,0.3,1.7,6,-36,478,442,0.653846154
234004,112,13,260,416,676,10,1,0.0,1.8,5,52,344,396,0.585798817
234005,112,13,260,416,676,10,1,0.0,1.9,9,-72,585,513,0.75887574
234006,111,6,135,201,336,4,0,0.5,1.5,2,19,161,180,0.535714286
235001,119,8,136,248,384,21,0,0.0,0.0,8,141,95,236,0.614583333
235001,119,8,136,248,384,21,0,0.0,1.0,7,219,95,314,0.817708333
235001,119,8,136,248,384,21,0,0.0,2.0,7,150,104,254,0.661458333
235001,119,8,136,248,384,22,0,0.0,2.8636363,7,130,136,266,0.692708333
236001,500,21,5400,5400,10800,24,0,0.0,4.0416665,24,6711,2209,8920,0.825925926
238001,100,50,1275,1275,2550,10,0,0.0,0.9,43,1447,942,2389,0.936862745
239001,96,24,300,552,852,10,0,0.0,0.0,21,399,401,800,0.938967136
239001,96,24,300,552,852,10,0,0.0,1.0,22,352,473,825,0.968309859
239001,96,24,300,552,852,10,0,0.0,2.0,24,385,467,852,1.0
240001,112,13,260,416,676,10,1,0.0,0.0,11,203,366,569,0.841715976
240002,112,13,260,416,676,10,1,0.0,0.0,12,287,358,645,0.954142012
240003,112,13,260,416,676,10,1,0.0,0.0,9,159,369,528,0.781065089
240004,112,9,180,288,468,6,0,0.0,0.0,7,253,170,423,0.903846154
241001,110,13,234,390,624,10,0,0.0,0.0,12,248,334,582,0.932692308
241002,110,13,234,390,624,10,0,0.0,0.0,10,154,410,564,0.903846154
241003,110,13,234,390,624,10,0,0.0,0.0,9,83,401,484,0.775641026
241004,95,3,108,105,213,3,0,0.0,0.0,3,96,117,213,1.0
242001,106,281,6560,7756,14316,216,0,0.0,0.0,184,4654,4186,8840,0.617490919
243001,112,13,260,416,676,10,1,0.0,2.0,10,163,419,582,0.860946746
243001,112,13,260,416,676,10,1,0.0,3.0,13,199,456,655,0.968934911
243002,112,13,260,416,676,10,1,0.2,1.8,11,217,392,609,0.900887574
243002,112,13,260,416,676,10,1,0.2,2.8,12,249,388,637,0.942307692
243003,112,13,260,416,676,10,1,0.0,2.0,12,165,504,669,0.98964497
243003,112,13,260,416,676,10,1,0.0,3.0,12,201,468,669,0.98964497
244001,90,6,195,135,330,10,0,1.5,11.3,2,103,43,146,0.442424242
244001,90,6,195,135,330,10,0,1.5,12.3,3,-32,205,173,0.524242424
244002,90,6,195,135,330,10,0,1.3,10.5,4,178,89,267,0.809090909
244002,90,6,195,135,330,10,0,1.3,11.5,4,175,99,274,0.83030303
244003,90,6,195,135,330,10,0,0.3,11.5,2,134,48,182,0.551515152
244003,90,6,195,135,330,10,0,0.3,12.5,3,189,17,206,0.624242424
244004,90,2,65,45,110,2,0,6.0,7.0,1,79,21,100,0.909090909
244004,90,2,65,45,110,2,0,6.0,8.0,1,59,41,100,0.909090909
246001,116,14,257,469,726,10,0,0.0,3.0,1,30,60,90,0.123966942
246002,112,13,260,416,676,10,1,0.0,3.0,1,64,15,79,0.116863905
246003,112,13,260,416,676,10,1,0.0,2.3,1,57,40,97,0.143491124
246004,112,13,260,416,676,10,1,0.0,2.9,3,21,196,217,0.321005917
246005,112,13,260,416,676,10,1,0.0,2.4,5,371,-46,325,0.480769231
246006,112,13,260,416,676,10,1,0.0,2.8,3,178,72,250,0.369822485
246008,112,13,260,416,676,10,1,0.0,2.0,1,28,45,73,0.107988166
246009,112,13,260,416,676,10,1,0.0,3.0,1,28,64,92,0.136094675
250001,112,13,260,416,676,10,1,0.0,0.0,8,134,344,478,0.707100592
250001,112,13,260,416,676,10,1,0.0,1.0,11,368,230,598,0.884615385
250002,112,13,260,416,676,10,1,0.0,0.0,8,45,420,465,0.687869822
250002,112,13,260,416,676,10,1,0.0,1.0,11,179,434,613,0.906804734
250003,112,13,260,416,676,10,1,0.0,0.0,13,320,331,651,0.963017751
250003,112,13,260,416,676,10,1,0.0,1.0,13,266,401,667,0.986686391
250004,112,13,260,416,676,10,1,0.0,0.0,14,89,583,672,0.99408284
250004,112,13,260,416,676,10,1,0.0,1.0,12,63,567,630,0.931952663
252001,112,13,260,416,676,10,1,0.5,0.5,13,647,24,671,0.99260355
252002,112,13,260,416,676,10,1,0.2,1.2,12,241,323,564,0.834319527
252003,112,13,260,416,676,10,1,0.2,0.8,11,133,499,632,0.934911243
254001,112,13,260,416,676,10,1,0.2,1.6,12,186,454,640,0.946745562
254002,112,13,260,416,676,10,1,0.5,1.4,15,583,77,660,0.976331361
254003,112,13,260,416,676,10,1,1.0,1.0,12,211,392,603,0.892011834
254004,112,13,260,416,676,10,1,0.6,1.4,8,-9,483,474,0.701183432
255001,112,13,260,416,676,10,1,0.0,0.0,10,111,409,520,0.769230769
255002,112,13,260,416,676,10,1,0.0,0.0,13,152,485,637,0.942307692
255003,112,13,260,416,676,10,1,0.0,0.0,11,16,605,621,0.918639053
255004,112,13,260,416,676,10,1,0.3,0.4,11,-289,833,544,0.804733728
255005,112,13,260,416,676,10,1,0.0,0.0,12,165,487,652,0.964497041
256001,116,17,306,578,884,12,0,0.0,0.0,17,590,290,880,0.995475113
256002,116,15,270,510,780,10,0,0.0,0.0,12,226,498,724,0.928205128
258001,113,24,564,864,1428,16,0,0.0,0.0,6,280,173,453,0.317226891
258001,114,27,594,972,1566,18,0,0.0,0.8888889,14,404,480,884,0.56449553
258001,114,27,594,972,1566,18,0,0.0,1.8888888,15,324,578,902,0.575989783
259001,112,13,260,416,676,10,1,0.0,0.0,12,440,167,607,0.897928994
259002,112,13,260,416,676,10,1,0.0,0.0,11,18,533,551,0.815088757
259003,112,13,260,416,676,10,1,0.0,0.0,12,92,481,573,0.847633136
259004,112,13,260,416,676,10,1,0.0,0.0,14,-44,706,662,0.979289941
259005,112,13,260,416,676,10,1,0.0,0.0,13,86,567,653,0.965976331
260001,112,13,260,416,676,10,1,0.0,2.0,9,275,172,447,0.661242604
260002,112,13,260,416,676,10,1,0.2,1.8,15,-129,789,660,0.976331361
260003,112,13,260,416,676,10,1,0.0,2.0,11,328,274,602,0.890532544
260004,112,13,260,416,676,10,1,0.4,1.6,14,228,422,650,0.961538462
261001,112,13,260,416,676,10,1,0.0,0.0,12,297,304,601,0.889053254
261002,112,13,260,416,676,10,1,0.0,0.0,12,109,467,576,0.852071006
261003,112,13,260,416,676,10,1,0.0,0.0,11,176,408,584,0.863905325
262001,482,19,5054,4712,9766,25,0,0.0,3.0,23,5349,1339,6688,0.684824903
262002,495,18,4610,4568,9178,22,0,0.0,2.8181818,15,4636,2518,7154,0.779472652
263001,97,42,1026,1139,2165,85,0,0.0,0.87058824,39,1266,781,2047,0.945496536
268001,161,2,20,17,37,10,0,0.0,0.0,1,1,1,2,0.054054054
268001,161,2,20,17,37,10,0,0.0,1.0,3,14,17,31,0.837837838
268001,161,2,20,17,37,10,0,0.0,2.0,2,17,20,37,1.0
268002,161,2,20,17,37,10,0,0.0,0.0,4,-1,-70,-71,-1.918918919
268002,161,2,20,17,37,10,0,0.0,1.0,3,10,-7,3,0.081081081
268002,161,2,20,17,37,10,0,0.0,2.0,3,1,-29,-28,-0.756756757
268003,161,2,20,17,37,10,0,0.0,0.0,2,19,18,37,1.0
268003,161,2,20,17,37,10,0,0.0,1.0,3,98,-62,36,0.972972973
268003,161,2,20,17,37,10,0,0.0,2.0,2,12,15,27,0.72972973
268004,161,2,20,17,37,10,0,0.0,0.0,7,161,-406,-245,-6.621621622
268004,161,2,20,17,37,10,0,0.0,1.0,6,-284,87,-197,-5.324324324
268004,161,2,20,17,37,10,0,0.0,2.0,7,83,-241,-158,-4.27027027
269001,63,15,675,450,1125,17,0,0.0,0.0,17,-98,1007,909,0.808
270001,115,50,2025,2025,4050,20,0,0.2,0.75,48,2209,1755,3964,0.978765432
270002,115,50,2025,2025,4050,20,0,0.1,0.85,48,2014,1945,3959,0.977530864
270003,115,50,2025,2025,4050,20,0,0.0,0.95,45,1238,2454,3692,0.911604938
270004,115,50,2025,2025,4050,20,0,0.0,1.0,47,1675,2239,3914,0.966419753
270005,115,50,2025,2025,4050,20,0,0.15,0.85,49,2033,1982,4015,0.991358025
270006,115,50,2025,2025,4050,20,0,0.05,0.95,49,1715,2294,4009,0.989876543
270007,115,50,2025,2025,4050,20,0,0.05,0.9,44,1821,1855,3676,0.907654321
270008,115,50,2025,2025,4050,20,0,0.1,0.9,47,1991,1893,3884,0.959012346
270009,115,50,2025,2025,4050,20,0,0.1,0.9,43,1610,2006,3616,0.892839506
270010,115,50,2025,2025,4050,20,0,0.15,0.85,42,2231,1352,3583,0.884691358
270011,115,50,2025,2025,4050,20,0,0.2,0.75,45,1596,2132,3728,0.920493827
271001,98,45,1260,1170,2430,19,0,0.0,0.0,28,604,1333,1937,0.797119342
272001,112,13,260,416,676,10,1,0.0,0.9,11,109,422,531,0.785502959
272002,112,13,260,416,676,10,1,0.0,1.0,10,201,397,598,0.884615385
272003,112,13,260,416,676,10,1,0.0,1.0,9,23,466,489,0.723372781
273001,123,10,135,315,450,28,0,0.0,0.0,7,-3,164,161,0.357777778
273001,123,10,135,315,450,28,0,0.0,1.0,9,40,233,273,0.606666667
273001,123,10,135,315,450,28,0,0.0,2.0,7,114,200,314,0.697777778
273001,123,10,135,315,450,28,0,0.0,3.0,10,89,95,184,0.408888889
274001,218,13,1872,1326,3198,12,0,0.5,0.5,11,1397,1233,2630,0.822388993
274001,218,13,1872,1326,3198,12,0,0.5,1.5,10,1294,1343,2637,0.824577861
274001,218,13,1872,1326,3198,12,0,0.5,2.5,10,1376,1309,2685,0.839587242
274002,218,13,1872,1326,3198,12,0,0.33333334,1.0833334,12,1200,1708,2908,0.909318324
274002,218,13,1872,1326,3198,12,0,0.33333334,2.0833333,12,1651,1393,3044,0.951844903
274002,218,13,1872,1326,3198,12,0,0.33333334,3.0833333,12,1493,1374,2867,0.896497811
275001,112,13,260,416,676,10,1,0.1,3.9,11,199,363,562,0.831360947
275002,112,13,260,416,676,10,1,0.0,3.2,12,171,424,595,0.880177515
275003,112,13,260,416,676,10,1,0.2,3.8,11,33,531,564,0.834319527
275004,112,13,260,416,676,10,1,0.6,4.3,13,-144,744,600,0.887573964
276001,95,10,135,225,360,10,0,0.0,0.0,11,218,111,329,0.913888889
276002,95,10,135,225,360,10,0,0.0,0.0,12,173,58,231,0.641666667
276003,95,10,135,225,360,10,0,0.0,0.0,11,198,142,340,0.944444444
276004,95,10,135,225,360,10,0,0.0,0.0,12,-174,480,306,0.85
277001,112,13,260,416,676,10,1,0.0,0.0,14,-141,807,666,0.985207101
277002,112,13,260,416,676,10,1,0.0,0.0,10,-17,586,569,0.841715976
277003,112,13,260,416,676,10,1,0.0,0.0,14,265,407,672,0.99408284
277004,112,13,260,416,676,10,1,0.0,0.0,13,421,228,649,0.960059172
277005,112,13,260,416,676,10,1,0.0,0.0,13,518,138,656,0.970414201
280002,110,4,118,156,274,2,0,2.0,3.0,4,118,156,274,1.0
280002,110,4,118,156,274,2,0,2.0,4.0,4,146,128,274,1.0
280002,97,4,170,156,326,3,0,1.3333334,3.3333333,4,219,107,326,1.0
282001,107,19,703,684,1387,14,0,0.0,0.0,17,354,1011,1365,0.984138428
282002,107,19,703,684,1387,14,0,0.0,0.0,19,596,731,1327,0.956741168
283001,122,10,145,360,505,10,0,0.0,3.0,11,-175,576,401,0.794059406
283002,122,10,145,360,505,10,0,0.0,3.0,7,159,217,376,0.744554455
283003,122,10,145,360,505,10,0,0.0,3.0,11,87,354,441,0.873267327
284001,105,12,276,330,606,9,0,0.0,3.7777777,10,463,105,568,0.937293729
284002,105,12,276,330,606,9,0,0.0,3.2222223,11,291,252,543,0.896039604
286001,112,13,260,416,676,10,1,0.0,0.0,12,349,253,602,0.890532544
286002,112,13,260,416,676,10,1,0.0,0.0,9,210,333,543,0.803254438
286003,112,13,260,416,676,10,1,0.0,0.0,11,413,196,609,0.900887574
286004,112,13,260,416,676,10,1,0.0,0.0,12,165,378,543,0.803254438
286005,112,13,260,416,676,10,1,0.0,0.0,8,273,210,483,0.714497041
286006,112,13,260,416,676,10,1,0.0,0.0,10,461,101,562,0.831360947
286007,112,13,260,416,676,10,1,0.0,0.0,13,9,661,670,0.99112426
286008,112,13,260,416,676,10,1,0.0,0.0,11,309,312,621,0.918639053
286009,112,13,260,416,676,10,1,0.0,0.0,13,443,194,637,0.942307692
286010,112,13,260,416,676,10,1,0.0,0.0,13,471,196,667,0.986686391
286011,112,13,260,416,676,10,1,0.0,0.0,11,229,326,555,0.821005917
286012,112,13,260,416,676,10,1,0.0,0.0,9,267,196,463,0.684911243
286013,112,13,260,416,676,10,1,0.0,0.0,8,8,448,456,0.674556213
286014,112,13,260,416,676,10,1,0.0,0.0,13,590,68,658,0.973372781
286015,112,13,260,416,676,10,1,0.0,0.0,14,416,227,643,0.951183432
286016,112,13,260,416,676,10,1,0.0,0.0,11,396,129,525,0.776627219
287001,400,14,1435,1435,2870,8,0,0.0,0.0,14,346,2374,2720,0.947735192
287002,400,14,1435,1435,2870,8,0,0.0,0.0,16,2209,441,2650,0.923344948
287003,400,14,1435,1435,2870,8,0,0.0,0.0,13,1595,1070,2665,0.928571429
287004,400,14,1435,1435,2870,8,0,0.0,0.0,13,2237,263,2500,0.871080139
287005,355,9,1185,720,1905,5,0,0.0,0.0,7,661,1059,1720,0.902887139
288001,112,13,260,416,676,10,1,0.3,0.7,12,355,299,654,0.967455621
288002,112,13,260,416,676,10,1,0.1,0.9,13,222,427,649,0.960059172
288003,112,13,260,416,676,10,1,0.1,0.9,10,154,420,574,0.849112426
288004,112,13,260,416,676,10,1,0.1,0.9,9,-5,481,476,0.704142012
288005,112,13,260,416,676,10,1,0.2,0.8,10,-27,616,589,0.871301775
289001,112,13,260,416,676,10,1,0.0,0.0,9,631,-89,542,0.801775148
289001,112,13,260,416,676,10,1,0.0,1.0,12,376,275,651,0.963017751
289001,112,13,260,416,676,10,1,0.0,2.0,10,120,451,571,0.844674556
289002,112,13,260,416,676,10,1,0.0,0.0,7,203,260,463,0.684911243
289002,112,13,260,416,676,10,1,0.0,1.0,11,315,307,622,0.920118343
289002,112,13,260,416,676,10,1,0.0,2.0,12,405,235,640,0.946745562
289003,112,13,260,416,676,10,1,0.0,0.0,9,51,500,551,0.815088757
289003,112,13,260,416,676,10,1,0.0,1.0,10,222,320,542,0.801775148
289003,112,13,260,416,676,10,1,0.0,2.0,10,148,344,492,0.727810651
289004,112,13,260,416,676,10,1,0.0,0.0,6,56,404,460,0.680473373
289004,112,13,260,416,676,10,1,0.0,1.0,9,77,486,563,0.832840237
289004,112,13,260,416,676,10,1,0.0,2.0,11,70,561,631,0.933431953
289005,112,13,260,416,676,10,1,0.0,0.0,6,190,240,430,0.636094675
289005,112,13,260,416,676,10,1,0.0,1.0,10,238,342,580,0.857988166
289005,112,13,260,416,676,10,1,0.0,2.0,12,295,294,589,0.871301775
289006,112,13,260,416,676,10,1,0.0,0.0,7,205,227,432,0.639053254
289006,112,13,260,416,676,10,1,0.0,1.0,13,450,190,640,0.946745562
289006,112,13,260,416,676,10,1,0.0,2.0,13,251,397,648,0.958579882
289007,112,13,260,416,676,10,1,0.0,0.0,9,198,355,553,0.818047337
289007,112,13,260,416,676,10,1,0.0,1.0,11,511,86,597,0.883136095
289007,112,13,260,416,676,10,1,0.0,2.0,12,541,93,634,0.937869822
289008,112,13,260,416,676,10,1,0.0,0.0,5,101,148,249,0.368343195
289008,112,13,260,416,676,10,1,0.0,1.0,12,69,534,603,0.892011834
289008,112,13,260,416,676,10,1,0.0,2.0,11,183,361,544,0.804733728
289009,112,13,260,416,676,10,1,0.0,0.0,8,215,259,474,0.701183432
289009,112,13,260,416,676,10,1,0.0,1.0,8,63,459,522,0.772189349
289009,112,13,260,416,676,10,1,0.0,2.0,11,234,350,584,0.863905325
289010,112,13,260,416,676,10,1,0.0,0.0,10,523,31,554,0.819526627
289010,112,13,260,416,676,10,1,0.0,1.0,10,683,-103,580,0.857988166
289010,112,13,260,416,676,10,1,0.0,2.0,10,656,-64,592,0.875739645
289011,112,13,260,416,676,10,1,0.0,0.0,12,512,145,657,0.971893491
289011,112,13,260,416,676,10,1,0.0,1.0,9,477,76,553,0.818047337
289011,112,13,260,416,676,10,1,0.0,2.0,8,446,52,498,0.736686391
289012,112,13,260,416,676,10,1,0.0,0.0,11,751,-165,586,0.866863905
289012,112,13,260,416,676,10,1,0.0,1.0,14,622,42,664,0.982248521
289012,112,13,260,416,676,10,1,0.0,2.0,10,427,121,548,0.810650888
289013,112,13,260,416,676,10,1,0.0,0.0,9,184,399,583,0.862426036
289013,112,13,260,416,676,10,1,0.0,1.0,12,385,254,639,0.945266272
289013,112,13,260,416,676,10,1,0.0,2.0,12,324,309,633,0.936390533
289014,112,13,260,416,676,10,1,0.0,0.0,8,301,207,508,0.75147929
289014,112,13,260,416,676,10,1,0.0,1.0,11,359,225,584,0.863905325
289014,112,13,260,416,676,10,1,0.0,2.0,11,305,315,620,0.917159763
289015,112,13,260,416,676,10,1,0.0,0.0,10,397,159,556,0.822485207
289015,112,13,260,416,676,10,1,0.0,1.0,11,396,248,644,0.952662722
289015,112,13,260,416,676,10,1,0.0,2.0,9,465,88,553,0.818047337
289016,112,13,260,416,676,10,1,0.0,0.0,10,278,292,570,0.843195266
289016,112,13,260,416,676,10,1,0.0,1.0,13,310,332,642,0.949704142
289016,112,13,260,416,676,10,1,0.0,2.0,12,546,117,663,0.980769231
289017,112,13,260,416,676,10,1,0.0,0.0,13,77,549,626,0.926035503
289017,112,13,260,416,676,10,1,0.0,1.0,10,-84,597,513,0.75887574
289017,112,13,260,416,676,10,1,0.0,2.0,12,25,605,630,0.931952663
289018,112,13,260,416,676,10,1,0.0,0.0,10,159,399,558,0.825443787
289018,112,13,260,416,676,10,1,0.0,1.0,14,79,561,640,0.946745562
289018,112,13,260,416,676,10,1,0.0,2.0,13,178,462,640,0.946745562
289019,112,13,260,416,676,10,1,0.0,0.0,6,385,24,409,0.605029586
289019,112,13,260,416,676,10,1,0.0,1.0,10,485,80,565,0.835798817
289019,112,13,260,416,676,10,1,0.0,2.0,10,478,99,577,0.853550296
289020,112,13,260,416,676,10,1,0.0,0.2,6,257,107,364,0.538461538
289020,112,13,260,416,676,10,1,0.0,1.2,12,532,113,645,0.954142012
289020,112,13,260,416,676,10,1,0.0,2.2,11,408,199,607,0.897928994
289021,101,6,195,201,396,5,0,0.0,0.0,5,274,50,324,0.818181818
289021,112,9,180,288,468,6,0,0.0,0.8333333,6,440,-134,306,0.653846154
290001,107,4,100,126,226,10,0,0.0,6.1,3,3,210,213,0.942477876
290001,107,4,100,126,226,10,0,0.0,7.1,3,81,98,179,0.792035398
290002,102,2,84,87,171,4,0,0.0,7.0,2,148,23,171,1.0
290002,102,2,84,87,171,5,0,0.0,8.6,2,116,55,171,1.0
291001,112,13,260,416,676,10,1,0.0,0.0,14,232,408,640,0.946745562
291002,112,13,260,416,676,10,1,0.0,0.0,13,266,391,657,0.971893491
291003,112,13,260,416,676,10,1,0.0,0.0,14,-335,978,643,0.951183432
291004,112,13,260,416,676,10,1,0.0,0.0,13,331,316,647,0.957100592
291005,112,13,260,416,676,10,1,0.0,0.0,13,137,497,634,0.937869822
291006,112,13,260,416,676,10,1,0.0,0.0,14,117,547,664,0.982248521
291007,112,13,260,416,676,10,1,0.0,0.0,14,55,600,655,0.968934911
291008,112,13,260,416,676,10,1,0.0,0.0,15,508,152,660,0.976331361
291010,112,13,260,416,676,10,1,0.0,0.0,15,479,181,660,0.976331361
293001,112,13,260,416,676,10,1,0.0,0.9,13,471,154,625,0.924556213
293001,112,13,260,416,676,10,1,0.0,1.9,13,430,207,637,0.942307692
293001,112,13,260,416,676,10,1,0.0,2.9,13,451,202,653,0.965976331
293002,112,13,260,416,676,10,1,0.0,1.6,9,129,391,520,0.769230769
293002,112,13,260,416,676,10,1,0.0,2.6,12,110,536,646,0.955621302
293002,112,13,260,416,676,10,1,0.0,3.6,13,297,373,670,0.99112426
293003,108,12,270,366,636,9,0,0.0,0.5555556,6,282,119,401,0.630503145
294001,96,7,210,266,476,10,0,0.0,5.0,9,107,334,441,0.926470588
294002,96,7,210,266,476,10,0,0.1,4.9,7,248,144,392,0.823529412
294003,96,7,210,266,476,10,0,0.1,4.9,8,208,244,452,0.949579832
294004,96,7,210,266,476,10,0,0.5,4.5,7,249,208,457,0.960084034
294005,96,7,210,266,476,10,0,0.1,4.9,7,188,223,411,0.863445378
294006,96,7,210,266,476,10,0,0.0,5.0,6,154,303,457,0.960084034
294007,96,7,210,266,476,10,0,0.0,5.0,8,103,354,457,0.960084034
294008,96,7,210,266,476,10,0,0.3,4.7,6,100,277,377,0.792016807
294009,96,7,210,266,476,10,0,0.8,4.2,7,211,265,476,1.0
294010,96,7,210,266,476,10,0,0.0,5.0,8,152,316,468,0.983193277
294011,96,7,210,266,476,10,0,0.1,4.9,8,149,262,411,0.863445378
294012,96,7,210,266,476,10,0,0.0,5.0,8,242,145,387,0.81302521
294013,96,7,210,266,476,10,0,0.4,4.6,5,168,117,285,0.598739496
294014,96,7,210,266,476,10,0,0.2,4.8,7,46,398,444,0.932773109
294015,96,7,210,266,476,10,0,0.8,3.7,8,98,337,435,0.913865546
294016,96,7,210,266,476,10,0,0.4,4.6,8,72,306,378,0.794117647
294017,96,7,210,266,476,10,0,0.4,4.6,6,150,288,438,0.920168067
294018,96,7,210,266,476,10,0,0.4,4.6,8,216,220,436,0.915966387
294019,96,7,210,266,476,10,0,0.1,4.9,8,68,367,435,0.913865546
294020,96,7,210,266,476,10,0,0.1,4.9,7,203,262,465,0.976890756
294021,96,7,210,266,476,10,0,0.5,4.5,8,146,295,441,0.926470588
294022,96,7,210,266,476,10,0,0.0,4.6,6,-148,523,375,0.787815126
294025,92,7,214,238,452,9,0,0.0,3.8888888,5,151,257,408,0.902654867
295001,100,8,204,204,408,10,0,0.2,0.8,8,189,198,387,0.948529412
295002,100,8,204,204,408,10,0,0.2,0.8,9,104,159,263,0.644607843
297001,108,5,110,150,260,4,0,0.0,0.0,6,138,102,240,0.923076923
298001,108,654,13746,19027,32773,318,0,0.0,0.0,422,13796,8098,21934,0.669270436
301001,100,36,1116,1116,2232,18,0,0.0,1.0,28,1677,203,1880,0.842293907
302001,103,17,894,665,1559,25,0,0.0,1.0,24,896,412,1308,0.838999359
303001,112,13,260,416,676,10,1,0.0,0.0,14,318,333,651,0.963017751
303002,112,13,260,416,676,10,1,0.0,0.0,11,548,74,622,0.920118343
303003,112,13,260,416,676,10,1,0.0,0.0,9,350,168,518,0.766272189
303004,112,13,260,416,676,10,1,0.0,0.0,10,451,127,578,0.855029586
303005,112,13,260,416,676,10,1,0.0,0.0,14,742,-88,654,0.967455621
303007,112,13,260,416,676,10,1,0.0,0.0,15,370,290,660,0.976331361
303008,97,3,114,111,225,3,0,0.0,0.0,3,119,61,180,0.8
305001,112,13,260,416,676,10,1,0.6,6.4,14,358,308,666,0.985207101
305002,112,13,260,416,676,10,1,0.6,5.9,13,179,487,666,0.985207101
305003,112,13,260,416,676,10,1,1.0,6.0,12,340,302,642,0.949704142
305004,112,13,260,416,676,10,1,1.3,5.6,11,172,391,563,0.832840237
306001,106,3,78,96,174,2,0,0.0,0.0,3,65,109,174,1.0
308001,112,13,260,416,676,10,1,0.8,0.2,10,91,432,523,0.773668639
308002,112,13,260,416,676,10,1,0.7,0.3,5,24,350,374,0.553254438
308003,112,13,260,416,676,10,1,0.9,0.1,15,265,395,660,0.976331361
308004,112,13,260,416,676,10,1,1.0,0.0,11,246,344,590,0.872781065
308005,112,13,260,416,676,10,1,1.0,0.0,10,154,369,523,0.773668639
308006,112,13,260,416,676,10,1,0.8,0.2,10,213,319,532,0.786982249
309001,112,13,260,416,676,10,1,0.0,1.0,13,322,308,630,0.931952663
309001,112,13,260,416,676,10,1,0.0,2.0,12,289,343,632,0.934911243
309001,112,13,260,416,676,10,1,0.0,0.0,13,508,117,625,0.924556213
309002,112,13,260,416,676,10,1,0.0,1.0,12,182,424,606,0.896449704
309002,112,13,260,416,676,10,1,0.0,2.0,14,350,317,667,0.986686391
309002,112,13,260,416,676,10,1,0.0,0.0,15,383,277,660,0.976331361
309003,112,13,260,416,676,10,1,0.2,1.5,14,57,615,672,0.99408284
309003,112,13,260,416,676,10,1,0.2,2.5,14,215,457,672,0.99408284
309003,112,13,260,416,676,10,1,0.2,0.5,15,214,446,660,0.976331361
309004,112,13,260,416,676,10,1,0.1,1.6,10,452,116,568,0.840236686
309004,112,13,260,416,676,10,1,0.1,2.6,13,364,254,618,0.914201183
309004,112,13,260,416,676,10,1,0.1,0.6,11,438,168,606,0.896449704
309005,112,13,260,416,676,10,1,0.0,1.0,9,173,345,518,0.766272189
309005,112,13,260,416,676,10,1,0.0,2.0,12,282,369,651,0.963017751
309005,112,13,260,416,676,10,1,0.0,0.0,12,228,371,599,0.886094675
309006,112,13,260,416,676,10,1,0.0,1.0,7,238,196,434,0.642011834
309006,112,13,260,416,676,10,1,0.0,2.0,13,433,179,612,0.905325444
309006,112,13,260,416,676,10,1,0.0,0.0,12,266,378,644,0.952662722
309007,112,13,260,416,676,10,1,0.0,1.0,12,353,259,612,0.905325444
309007,112,13,260,416,676,10,1,0.0,2.0,13,510,147,657,0.971893491
309007,112,13,260,416,676,10,1,0.0,0.0,14,240,400,640,0.946745562
310001,105,2,65,75,140,2,0,0.0,0.0,3,90,30,120,0.857142857
311001,112,13,260,416,676,10,1,0.0,2.0,14,474,198,672,0.99408284
314001,75,4,58,58,116,10,0,0.0,0.0,8,-137,124,-13,-0.112068966
314001,75,4,58,58,116,10,0,0.0,1.0,8,-20,-28,-48,-0.413793103
314001,75,4,58,58,116,10,0,0.0,2.0,8,-49,36,-13,-0.112068966
314002,75,4,58,58,116,10,0,0.0,0.0,8,7,-48,-41,-0.353448276
314002,75,4,58,58,116,10,0,0.0,1.0,7,-30,2,-28,-0.24137931
314002,75,4,58,58,116,10,0,0.0,2.0,5,0,-2,-2,-0.017241379
314003,75,4,58,58,116,10,0,0.0,0.0,9,-522,440,-82,-0.706896552
314003,75,4,58,58,116,10,0,0.0,1.0,7,194,-201,-7,-0.060344828
314003,75,4,58,58,116,10,0,0.0,2.0,6,76,-70,6,0.051724138
314004,75,4,58,58,116,10,0,0.0,0.0,9,-26,-28,-54,-0.465517241
314004,75,4,58,58,116,10,0,0.0,1.0,8,6,-19,-13,-0.112068966
314004,75,4,58,58,116,10,0,0.0,2.0,8,-41,0,-41,-0.353448276
314006,75,4,58,58,116,10,0,0.0,0.0,6,-18,52,34,0.293103448
314006,75,4,58,58,116,10,0,0.0,1.0,5,49,26,75,0.646551724
314006,75,4,58,58,116,10,0,0.0,2.0,7,20,15,35,0.301724138
315001,89,134,4336,4151,8487,75,0,0.0,1.0,142,5054,1536,6590,0.776481678
317001,112,13,260,416,676,10,1,0.0,0.0,14,298,364,662,0.979289941
317002,112,13,260,416,676,10,1,0.0,0.0,12,19,604,623,0.921597633
319001,100,32,1746,1619,3365,24,0,0.0,4.4166665,32,809,1803,2612,0.776225854
319002,102,20,769,899,1668,16,0,0.0,3.25,12,-263,1170,907,0.543764988
320001,122,10,145,360,505,10,0,0.0,0.0,5,186,104,290,0.574257426
320001,122,10,145,360,505,10,0,0.0,1.0,9,75,381,456,0.902970297
320001,122,10,145,360,505,10,0,0.0,2.0,10,265,124,389,0.77029703
320002,122,10,145,360,505,10,0,0.0,0.0,5,122,212,334,0.661386139
320002,122,10,145,360,505,10,0,0.0,1.0,9,220,194,414,0.81980198
320002,122,10,145,360,505,10,0,0.0,2.0,9,117,325,442,0.875247525
320003,122,10,145,360,505,10,0,0.0,0.0,8,65,287,352,0.697029703
320003,122,10,145,360,505,10,0,0.0,1.0,11,236,220,456,0.902970297
320003,122,10,145,360,505,10,0,0.0,2.0,9,-80,522,442,0.875247525
321001,96,24,300,552,852,10,0,0.0,0.0,21,8,812,820,0.962441315
321001,96,24,300,552,852,10,0,0.0,1.0,21,113,697,810,0.950704225
321001,96,24,300,552,852,10,0,0.0,2.0,19,278,495,773,0.907276995
323001,65,13,780,390,1170,10,0,0.4,3.8,10,155,940,1095,0.935897436
323001,65,13,780,390,1170,10,0,0.4,4.8,10,363,647,1010,0.863247863
323002,65,13,780,390,1170,10,0,0.4,3.6,9,307,733,1040,0.888888889
323002,65,13,780,390,1170,10,0,0.4,4.6,7,318,582,900,0.769230769
325001,112,13,260,416,676,10,1,0.3,0.0,12,568,50,618,0.914201183
325001,112,13,260,416,676,10,1,0.3,1.0,12,-749,1304,555,0.821005917
325002,112,13,260,416,676,10,1,0.0,0.0,14,136,533,669,0.98964497
325002,112,13,260,416,676,10,1,0.0,1.0,10,241,361,602,0.890532544
328001,112,13,260,416,676,10,1,0.3,3.8,12,112,425,537,0.794378698
328002,112,13,260,416,676,10,1,0.1,3.9,9,-276,645,369,0.545857988
328003,112,13,260,416,676,10,1,0.4,3.6,12,-61,620,559,0.826923077
328004,112,13,260,416,676,10,1,0.9,3.1,9,307,240,547,0.809171598
328005,112,13,260,416,676,10,1,1.0,3.0,13,424,210,634,0.937869822
331001,112,13,260,416,676,10,1,0.2,3.4,12,287,343,630,0.931952663
331002,112,13,260,416,676,10,1,0.5,3.5,13,171,490,661,0.977810651
331003,112,13,260,416,676,10,1,0.4,3.2,13,302,363,665,0.983727811
332001,100,25,650,650,1300,10,0,0.0,0.0,23,127,1151,1278,0.983076923
332002,100,25,650,650,1300,10,0,0.0,0.1,21,542,652,1194,0.918461538
332003,100,25,650,650,1300,10,0,0.0,0.0,21,-387,1599,1212,0.932307692
332004,100,25,650,650,1300,10,0,0.0,0.0,25,681,619,1300,1.0
332005,100,25,650,650,1300,10,0,0.0,0.0,23,-102,1366,1264,0.972307692
333001,130,61,3660,3660,7320,20,0,0.0,1.9,61,4285,1447,5732,0.783060109
333002,102,15,1226,750,1976,5,0,0.0,0.4,6,482,498,980,0.495951417
334001,112,13,260,416,676,10,1,0.3,1.3,9,436,127,563,0.832840237
334002,112,13,260,416,676,10,1,0.2,1.6,10,311,214,525,0.776627219
334003,112,13,260,416,676,10,1,0.2,2.3,12,476,165,641,0.948224852
334004,112,13,260,416,676,10,1,0.0,1.8,12,472,189,661,0.977810651
334005,112,13,260,416,676,10,1,0.2,1.8,10,203,374,577,0.853550296
334006,112,13,260,416,676,10,1,0.2,1.8,10,355,243,598,0.884615385
335001,112,13,260,416,676,10,1,0.4,1.6,10,389,80,469,0.693786982
335002,112,13,260,416,676,10,1,0.0,2.0,13,536,110,646,0.955621302
335003,112,13,260,416,676,10,1,0.4,1.6,10,272,288,560,0.828402367
335004,112,13,260,416,676,10,1,0.4,1.6,11,361,234,595,0.880177515
336001,95,23,529,529,1058,47,0,0.0,0.0,19,325,583,908,0.858223062
336001,95,23,529,529,1058,47,0,0.0,1.0,14,293,401,694,0.655954631
338001,112,13,260,416,676,10,1,0.0,0.0,13,176,476,652,0.964497041
340001,116,17,306,578,884,12,0,0.0,1.0,15,321,519,840,0.950226244
341001,96,10,155,235,390,10,0,0.0,1.0,12,219,35,254,0.651282051
341001,96,10,155,235,390,10,0,0.0,2.0,13,90,213,303,0.776923077
341002,96,10,155,235,390,10,0,0.1,0.9,9,118,259,377,0.966666667
341002,96,10,155,235,390,10,0,0.1,1.9,7,115,163,278,0.712820513
341003,96,10,155,235,390,10,0,0.1,0.9,10,234,108,342,0.876923077
341003,96,10,155,235,390,10,0,0.1,1.9,8,200,146,346,0.887179487
341004,96,10,155,235,390,10,0,0.4,1.5,11,174,153,327,0.838461538
341004,96,10,155,235,390,10,0,0.4,2.5,10,105,215,320,0.820512821
341005,96,10,155,235,390,10,0,0.1,0.9,10,120,191,311,0.797435897
341005,96,10,155,235,390,10,0,0.1,1.9,11,71,311,382,0.979487179
342001,105,45,1620,1485,3105,19,0,0.0,1.0,37,1754,938,2692,0.866988728
348001,84,5,170,90,260,6,0,0.0,0.0,8,131,-3,128,0.492307692
349001,110,13,390,390,780,10,0,0.0,0.9,11,-72,757,685,0.878205128
349002,110,13,390,390,780,10,0,0.0,1.0,9,249,376,625,0.801282051
349003,110,13,390,390,780,10,0,0.0,0.9,10,129,526,655,0.83974359
349004,110,13,390,390,780,10,0,0.0,0.9,10,-10,610,600,0.769230769
349005,110,13,390,390,780,10,0,0.0,1.0,8,170,410,580,0.743589744
349006,110,13,390,390,780,10,0,0.0,1.0,10,294,381,675,0.865384615
349007,110,13,390,390,780,10,0,0.0,1.0,11,408,252,660,0.846153846
349008,110,13,390,390,780,10,0,0.0,1.0,13,76,669,745,0.955128205
349009,110,13,390,390,780,10,0,0.0,1.0,9,319,301,620,0.794871795
349010,110,13,390,390,780,10,0,0.0,0.9,12,120,570,690,0.884615385
349011,110,13,390,390,780,10,0,0.0,1.0,11,5,695,700,0.897435897
349012,110,13,390,390,780,10,0,0.0,1.0,13,257,493,750,0.961538462
349013,110,13,390,390,780,10,0,0.0,0.9,10,283,367,650,0.833333333
349014,110,13,390,390,780,10,0,0.0,1.0,10,290,360,650,0.833333333
349015,110,13,390,390,780,10,0,0.0,1.0,10,301,394,695,0.891025641
349016,110,13,390,390,780,10,0,0.0,1.0,11,452,248,700,0.897435897
349017,110,13,390,390,780,10,0,0.0,1.0,13,229,491,720,0.923076923
349018,110,13,390,390,780,10,0,0.0,0.9,11,163,522,685,0.878205128
349019,110,13,390,390,780,10,0,0.0,1.0,11,-287,947,660,0.846153846
349020,110,13,390,390,780,10,0,0.0,1.0,11,757,-22,735,0.942307692
349021,110,13,390,390,780,10,0,0.0,1.0,14,-115,860,745,0.955128205
349022,110,13,390,390,780,10,0,0.0,1.0,12,344,296,640,0.820512821
349023,110,13,390,390,780,10,0,0.0,1.0,13,-286,1001,715,0.916666667
349024,110,13,390,390,780,10,0,0.0,1.0,11,220,510,730,0.935897436
349025,110,13,390,390,780,10,0,0.0,1.0,8,208,337,545,0.698717949
349026,105,9,315,285,600,7,0,0.0,1.0,6,534,-89,445,0.741666667
350001,65,13,780,390,1170,10,0,0.8,4.2,7,292,613,905,0.773504274
350002,65,13,780,390,1170,10,0,0.4,4.6,9,261,759,1020,0.871794872
350003,65,13,780,390,1170,10,0,1.2,3.8,8,424,536,960,0.820512821
351001,143,4,16,6,22,14,0,0.0,0.0,11,21,-146,-125,-5.681818182
352001,112,13,260,416,676,10,1,0.6,2.4,14,220,449,669,0.98964497
352001,112,13,260,416,676,10,1,0.6,3.4,14,295,374,669,0.98964497
352001,112,13,260,416,676,10,1,0.6,4.4,12,309,300,609,0.900887574
352002,111,6,135,201,336,4,0,0.0,1.5,4,125,159,284,0.845238095
353001,127,8,100,232,332,10,0,0.0,0.0,8,212,82,294,0.885542169
353002,127,8,100,232,332,10,0,0.0,0.0,8,131,85,216,0.65060241
354001,116,17,306,578,884,12,0,0.0,1.0,9,546,44,590,0.667420814
354002,116,17,306,578,884,12,0,0.0,1.0,15,588,216,804,0.909502262
355001,112,13,260,416,676,10,1,0.2,0.3,13,512,150,662,0.979289941
355002,112,13,260,416,676,10,1,0.0,0.0,13,412,248,660,0.976331361
355003,112,13,260,416,676,10,1,0.0,0.0,11,295,329,624,0.923076923
355004,112,13,260,416,676,10,1,0.2,0.8,13,179,437,616,0.911242604
355005,112,13,260,416,676,10,1,0.0,0.0,13,151,499,650,0.961538462
357001,112,13,260,416,676,10,1,0.9,4.9,11,452,167,619,0.915680473
357001,112,13,260,416,676,10,1,0.9,5.9,10,266,253,519,0.767751479
358001,107,15,330,435,765,11,0,0.0,2.4545455,9,-105,747,642,0.839215686
358002,107,15,330,435,765,11,0,0.0,3.909091,6,152,277,429,0.560784314
360001,112,13,260,416,676,10,1,0.0,0.0,13,331,265,596,0.881656805
360001,112,13,260,416,676,10,1,0.0,1.0,14,-131,779,648,0.958579882
360001,112,13,260,416,676,10,1,0.0,2.0,12,423,180,603,0.892011834
360002,112,13,260,416,676,10,1,0.0,0.0,11,115,432,547,0.809171598
360002,112,13,260,416,676,10,1,0.0,1.0,13,500,164,664,0.982248521
360002,112,13,260,416,676,10,1,0.0,2.0,11,176,437,613,0.906804734
360003,112,13,260,416,676,10,1,0.0,0.0,14,364,291,655,0.968934911
360003,112,13,260,416,676,10,1,0.0,1.0,12,579,-11,568,0.840236686
360003,112,13,260,416,676,10,1,0.0,2.0,14,320,333,653,0.965976331
361001,96,10,155,235,390,10,0,0.2,2.8,12,-14,362,348,0.892307692
361001,96,10,155,235,390,10,0,0.2,3.8,11,220,139,359,0.920512821
361002,96,10,155,235,390,10,0,0.6,2.4,8,193,168,361,0.925641026
361002,96,10,155,235,390,10,0,0.6,3.4,11,16,331,347,0.88974359
361003,96,10,155,235,390,10,0,0.3,2.7,9,160,189,349,0.894871795
361003,96,10,155,235,390,10,0,0.3,3.7,11,111,268,379,0.971794872
364001,107,15,330,435,765,14,0,0.21428572,0.71428573,16,196,496,692,0.904575163
364002,107,15,330,435,765,14,0,0.14285715,0.78571427,18,523,185,708,0.925490196
365001,112,13,260,416,676,10,1,0.2,0.8,12,302,327,629,0.930473373
365002,112,13,260,416,676,10,1,0.0,1.0,11,292,228,520,0.769230769
365003,112,13,260,416,676,10,1,0.0,1.0,13,343,333,676,1.0
365004,112,13,260,416,676,10,1,0.0,1.0,12,178,486,664,0.982248521
366001,65,13,780,390,1170,10,0,0.2,4.8,11,-82,1092,1010,0.863247863
366001,65,13,780,390,1170,10,0,0.2,5.8,8,69,751,820,0.700854701
366002,65,13,780,390,1170,10,0,0.4,4.1,7,316,474,790,0.675213675
366002,65,13,780,390,1170,10,0,0.4,5.1,6,239,546,785,0.670940171
366003,65,13,780,390,1170,10,0,0.3,4.2,7,366,449,815,0.696581197
366003,65,13,780,390,1170,10,0,0.3,5.2,4,190,370,560,0.478632479
369001,78,52,1317,647,1964,40,0,0.0,0.0,39,-163,1781,1618,0.823828921
369001,78,52,1317,647,1964,40,0,0.0,1.0,47,307,1421,1728,0.879837067
369002,78,52,1317,647,1964,40,0,0.0,0.0,45,262,1449,1711,0.871181263
369002,78,52,1317,647,1964,40,0,0.0,1.0,52,585,1235,1820,0.926680244
369003,78,52,1317,647,1964,40,0,0.0,0.0,35,1053,321,1374,0.699592668
369003,78,52,1317,647,1964,40,0,0.0,1.0,42,1364,281,1645,0.837576375
369004,78,52,1317,647,1964,40,0,0.0,0.0,32,44,1277,1321,0.672606925
369004,78,52,1317,647,1964,40,0,0.0,1.0,44,539,1134,1673,0.851832994
369005,78,52,1317,647,1964,40,0,0.0,0.0,41,244,1318,1562,0.795315682
369005,78,52,1317,647,1964,40,0,0.0,1.0,48,554,1132,1686,0.858452138
369006,77,38,955,447,1402,29,0,0.0,0.0,30,-498,1678,1180,0.841654779
369006,78,39,966,485,1451,30,0,0.0,0.96666664,35,-60,1353,1293,0.89110958
370001,116,17,306,578,884,12,0,0.083333336,4.0,14,492,298,790,0.893665158
371001,75,8,116,312,428,10,0,0.4,1.6,10,101,275,376,0.878504673
371002,75,8,116,312,428,10,0,0.5,1.5,10,36,327,363,0.848130841
373001,99,17,427,305,732,35,0,0.0,0.0,16,649,31,680,0.928961749
373001,99,17,427,305,732,35,0,0.0,1.0,17,287,395,682,0.931693989
373001,99,17,427,305,732,35,0,0.0,2.0,16,224,495,719,0.982240437
373001,99,17,427,305,732,35,0,0.0,3.0,16,250,420,670,0.915300546
373001,99,17,427,305,732,35,0,0.0,4.0,17,310,398,708,0.967213115
374001,78,13,312,156,468,10,0,0.8,6.5,13,-211,667,456,0.974358974
374001,78,13,312,156,468,10,0,0.8,7.5,12,-294,728,434,0.927350427
374002,78,13,312,156,468,10,0,1.0,7.0,8,-24,378,354,0.756410256
374002,78,13,312,156,468,10,0,1.0,8.0,14,-120,570,450,0.961538462
375001,112,13,260,416,676,10,1,0.6,1.8,7,443,3,446,0.659763314
375002,112,13,260,416,676,10,1,0.6,2.4,5,218,130,348,0.514792899
375003,112,13,260,416,676,10,1,0.6,2.4,10,31,544,575,0.850591716
375004,112,13,260,416,676,10,1,0.8,1.9,10,546,55,601,0.889053254
375005,112,13,260,416,676,10,1,0.7,2.3,8,56,458,514,0.76035503
375006,112,13,260,416,676,10,1,0.7,2.3,12,577,51,628,0.928994083
375007,112,13,260,416,676,10,1,0.8,2.2,11,523,24,547,0.809171598
376001,78,26,358,376,734,34,0,0.0,0.029411765,41,-476,905,429,0.584468665
378001,137,8,164,156,320,10,0,0.1,5.8,9,125,170,295,0.921875
378001,137,8,164,156,320,10,0,0.1,6.8,8,149,171,320,1.0
378001,137,8,164,156,320,10,0,0.1,7.8,8,143,147,290,0.90625
378002,137,8,164,156,320,10,0,0.7,5.3,8,175,125,300,0.9375
378002,137,8,164,156,320,10,0,0.7,6.3,8,66,244,310,0.96875
378002,137,8,164,156,320,10,0,0.7,7.3,8,150,145,295,0.921875
378003,137,8,164,156,320,10,0,1.2,4.7,8,72,218,290,0.90625
378003,137,8,164,156,320,10,0,1.2,5.7,6,91,119,210,0.65625
378003,137,8,164,156,320,10,0,1.2,6.7,9,133,167,300,0.9375
379001,105,12,276,330,606,9,0,0.6666667,6.0,12,199,302,501,0.826732673
379001,105,12,276,330,606,9,0,0.6666667,7.0,11,208,339,547,0.902640264
381001,112,13,260,416,676,10,1,0.0,1.0,10,247,303,550,0.813609467
381002,112,13,260,416,676,10,1,0.0,0.8,6,186,135,321,0.474852071
382001,96,10,155,235,390,10,0,2.0,0.0,11,65,274,339,0.869230769
382001,96,10,155,235,390,10,0,2.0,1.0,12,10,339,349,0.894871795
382002,96,10,155,235,390,10,0,2.0,0.0,10,115,237,352,0.902564103
382002,96,10,155,235,390,10,0,2.0,1.0,11,107,256,363,0.930769231
382003,96,10,155,235,390,10,0,2.0,0.0,11,181,196,377,0.966666667
382003,96,10,155,235,390,10,0,2.0,1.0,11,201,150,351,0.9
382004,91,8,146,168,314,7,0,2.0,0.0,8,110,184,294,0.936305732
382004,91,8,146,168,314,7,0,2.0,1.0,8,100,214,314,1.0
385001,107,4,100,126,226,10,0,0.0,0.0,5,4,206,210,0.92920354
385001,107,4,100,126,226,10,0,0.0,1.0,5,46,164,210,0.92920354
385001,107,4,100,126,226,10,0,0.0,2.0,3,50,151,201,0.889380531
385002,107,4,100,126,226,10,0,0.0,0.0,5,22,188,210,0.92920354
385002,107,4,100,126,226,10,0,0.0,1.0,5,72,138,210,0.92920354
385002,107,4,100,126,226,10,0,0.0,2.0,5,141,69,210,0.92920354
385003,107,4,100,126,226,10,0,0.0,0.0,5,-19,229,210,0.92920354
385003,107,4,100,126,226,10,0,0.0,1.0,5,68,142,210,0.92920354
385003,107,4,100,126,226,10,0,0.0,2.0,5,-36,246,210,0.92920354
385004,107,4,100,126,226,10,0,0.0,0.0,5,215,-5,210,0.92920354
385004,107,4,100,126,226,10,0,0.0,1.0,5,174,36,210,0.92920354
385004,107,4,100,126,226,10,0,0.0,2.0,4,56,122,178,0.787610619
385005,107,4,100,126,226,10,0,0.0,0.0,5,151,59,210,0.92920354
385005,107,4,100,126,226,10,0,0.0,1.0,5,142,68,210,0.92920354
385005,107,4,100,126,226,10,0,0.0,2.0,1,40,-5,35,0.154867257
385006,107,4,100,126,226,10,0,0.0,0.0,5,143,67,210,0.92920354
385006,107,4,100,126,226,10,0,0.0,1.0,5,-56,266,210,0.92920354
385006,107,4,100,126,226,10,0,0.0,2.0,1,53,13,66,0.292035398
386001,102,17,136,136,272,14,0,0.85714287,3.142857,17,67,202,269,0.988970588
386002,102,17,136,136,272,14,0,0.64285713,3.2857144,17,78,191,269,0.988970588
388001,248,28,1624,2128,3752,14,0,0.0,0.071428575,30,2368,1238,3606,0.96108742
390001,130,15,795,675,1470,10,0,2.5,3.5,15,919,551,1470,1.0
390002,130,15,795,675,1470,10,0,1.9,3.5,14,868,563,1431,0.973469388
390003,130,15,795,675,1470,10,0,1.6,4.3,14,111,1320,1431,0.973469388
390004,130,15,795,675,1470,10,0,2.2,3.8,13,569,778,1347,0.916326531
390005,130,15,795,675,1470,10,0,1.3,4.1,14,775,650,1425,0.969387755
391001,104,9,234,270,504,7,0,0.0,0.85714287,9,336,144,480,0.952380952
392001,116,34,595,1122,1717,18,0,0.0,0.0,27,1311,271,1582,0.92137449
394001,550,11,1395,1395,2790,36,0,0.0,3.0,16,127,1531,1658,0.594265233
395001,112,13,260,416,676,10,1,0.0,2.0,14,713,-50,663,0.980769231
395002,112,13,260,416,676,10,1,0.0,2.0,13,225,385,610,0.902366864
395003,107,9,225,303,528,7,0,0.0,2.0,8,240,201,441,0.835227273
396001,200,34,3434,3434,6868,32,0,0.125,3.875,40,3521,2477,5998,0.873325568
396001,200,34,3434,3434,6868,32,0,0.125,4.875,37,3600,2368,5968,0.868957484
396001,200,34,3434,3434,6868,32,0,0.125,5.875,34,3679,2559,6238,0.908270239
396001,200,34,3434,3434,6868,32,0,0.125,6.875,32,3675,2675,6350,0.924577752
397001,112,13,260,416,676,10,1,0.0,0.8,12,308,290,598,0.884615385
397002,112,13,260,416,676,10,1,0.0,0.9,11,273,334,607,0.897928994
397003,112,13,260,416,676,10,1,0.0,1.0,9,120,407,527,0.779585799
397004,108,12,270,366,636,9,0,0.0,0.6666667,7,123,324,447,0.702830189
398001,112,13,260,416,676,10,1,0.0,0.0,6,249,201,450,0.665680473
398002,112,13,260,416,676,10,1,0.0,0.0,5,308,65,373,0.551775148
399001,98,17,272,408,680,16,0,0.0,0.0,20,-169,790,621,0.913235294
399001,98,17,272,408,680,16,0,0.0,1.0,19,346,294,640,0.941176471
399002,98,17,272,408,680,16,0,0.0,0.0,19,249,320,569,0.836764706
399002,98,17,272,408,680,16,0,0.0,1.0,16,349,120,469,0.689705882
399003,98,17,272,408,680,16,0,0.0,0.125,18,-781,1312,531,0.780882353
399003,98,17,272,408,680,16,0,0.0,1.125,13,-84,483,399,0.586764706
399004,98,17,272,408,680,16,0,0.0,0.125,21,-164,724,560,0.823529412
399004,98,17,272,408,680,16,0,0.0,1.125,20,-16,581,565,0.830882353
399005,98,17,272,408,680,16,0,0.0,0.375,19,78,471,549,0.807352941
399005,98,17,272,408,680,16,0,0.0,1.375,20,289,341,630,0.926470588
399006,98,17,272,408,680,16,0,0.0,0.125,18,277,326,603,0.886764706
399006,98,17,272,408,680,16,0,0.0,1.125,19,390,244,634,0.932352941
399007,98,17,272,408,680,16,0,0.0,0.0,22,276,288,564,0.829411765
399007,98,17,272,408,680,16,0,0.0,1.0,17,261,346,607,0.892647059
399008,98,17,272,408,680,16,0,0.0,0.25,14,298,287,585,0.860294118
399008,98,17,272,408,680,16,0,0.0,1.25,17,324,264,588,0.864705882
399009,98,17,272,408,680,16,0,0.0,0.25,11,365,112,477,0.701470588
399009,98,17,272,408,680,16,0,0.0,1.25,19,629,-57,572,0.841176471
399010,89,8,202,180,382,7,0,0.0,0.2857143,3,103,59,162,0.42408377
400001,114,19,342,513,855,39,0,0.0,0.0,15,-89,740,651,0.761403509
400001,114,19,342,513,855,39,0,0.0,1.0,18,99,681,780,0.912280702
401002,112,13,260,416,676,10,1,0.0,0.0,4,82,238,320,0.473372781
402001,92,3,114,94,208,3,0,0.0,0.0,2,142,30,172,0.826923077
404001,662,10,2380,1245,3625,34,0,0.0,6.7941175,8,202,1648,1850,0.510344828
405001,67,17,67,145,212,18,0,0.0,2.0,23,-754,804,50,0.235849057
406001,119,4,70,46,116,9,0,0.0,0.33333334,2,56,20,76,0.655172414
406001,119,4,70,46,116,9,0,0.0,1.3333334,3,98,-27,71,0.612068966
406002,119,4,70,46,116,9,0,0.0,0.0,4,111,0,111,0.956896552
406002,119,4,70,46,116,9,0,0.0,1.0,4,40,47,87,0.75
407001,78,13,312,156,468,10,0,0.7,8.3,6,86,240,326,0.696581197
407001,78,13,312,156,468,10,0,0.7,9.3,5,49,207,256,0.547008547
407002,78,13,312,156,468,10,0,1.1,6.8,6,62,240,302,0.645299145
407002,78,13,312,156,468,10,0,1.1,7.8,7,101,245,346,0.739316239
407003,78,13,312,156,468,10,0,0.8,7.8,6,40,284,324,0.692307692
407003,78,13,312,156,468,10,0,0.8,8.8,6,22,306,328,0.700854701
407004,78,13,312,156,468,10,0,0.2,8.6,5,30,254,284,0.606837607
407004,78,13,312,156,468,10,0,0.2,9.6,6,17,297,314,0.670940171
407005,78,13,312,156,468,10,0,1.7,7.1,4,11,223,234,0.5
407005,78,13,312,156,468,10,0,1.7,8.1,7,-24,400,376,0.803418803
408001,112,13,260,416,676,10,1,0.0,1.6,8,362,189,551,0.815088757
408002,112,13,260,416,676,10,1,0.0,1.5,10,286,301,587,0.868343195
408003,112,13,260,416,676,10,1,0.0,1.8,11,-124,690,566,0.837278107
408004,108,12,270,366,636,9,0,0.0,1.7777778,9,194,379,573,0.900943396
412001,100,7,170,170,340,14,0,0.0,0.0,6,197,119,316,0.929411765
413001,78,13,312,156,468,10,0,1.3,7.2,7,120,214,334,0.713675214
413001,78,13,312,156,468,10,0,1.3,8.2,7,120,246,366,0.782051282
413002,78,13,312,156,468,10,0,1.3,7.7,6,90,252,342,0.730769231
413002,78,13,312,156,468,10,0,1.3,8.7,4,57,177,234,0.5
413003,78,13,312,156,468,10,0,1.1,6.9,8,-57,393,336,0.717948718
413003,78,13,312,156,468,10,0,1.1,7.9,8,-35,379,344,0.735042735
413004,78,13,312,156,468,10,0,0.9,8.9,2,45,81,126,0.269230769
413004,78,13,312,156,468,10,0,0.9,9.9,5,86,208,294,0.628205128
413005,78,13,312,156,468,10,0,1.5,7.3,7,-35,357,322,0.688034188
413005,78,13,312,156,468,10,0,1.5,8.3,8,-97,465,368,0.786324786
414001,112,20,510,740,1250,10,0,0.0,0.3,18,628,567,1195,0.956
415001,112,13,260,416,676,10,1,0.0,3.5,10,199,429,628,0.928994083
415002,112,13,260,416,676,10,1,0.0,4.0,10,96,503,599,0.886094675
415003,112,13,260,416,676,10,1,0.1,3.9,9,147,426,573,0.847633136
415004,112,13,260,416,676,10,1,0.0,3.6,11,309,324,633,0.936390533
415005,112,13,260,416,676,10,1,0.0,4.0,9,65,515,580,0.857988166
415006,112,13,260,416,676,10,1,0.0,4.0,10,-19,654,635,0.939349112
415007,112,13,260,416,676,10,1,0.0,3.6,9,214,366,580,0.857988166
415008,112,13,260,416,676,10,1,0.1,3.9,9,248,294,542,0.801775148
415009,112,13,260,416,676,10,1,0.1,3.9,9,96,462,558,0.825443787
415010,112,13,260,416,676,10,1,0.0,3.5,11,318,306,624,0.923076923
415011,112,13,260,416,676,10,1,0.0,3.6,9,68,491,559,0.826923077
415012,112,13,260,416,676,10,1,0.0,3.6,7,172,315,487,0.720414201
415014,111,6,135,201,336,4,0,0.0,3.0,1,54,38,92,0.273809524
416001,115,30,585,1026,1611,21,0,0.0,0.0,26,64,1461,1525,0.946617008
417001,241,24,1476,1728,3204,12,0,0.0,1.0833334,26,991,2016,3007,0.938514357
418001,65,13,780,390,1170,10,0,0.2,4.3,6,269,436,705,0.602564103
418001,65,13,780,390,1170,10,0,0.2,5.3,5,250,360,610,0.521367521
418002,65,13,780,390,1170,10,0,0.6,4.3,9,220,765,985,0.841880342
418002,65,13,780,390,1170,10,0,0.6,5.3,9,321,729,1050,0.897435897
418003,65,13,780,390,1170,10,0,0.3,4.8,5,284,416,700,0.598290598
418003,65,13,780,390,1170,10,0,0.3,5.8,9,112,868,980,0.837606838
418005,57,3,234,126,360,3,0,1.3333334,3.6666667,2,170,115,285,0.791666667
419001,100,50,1275,1275,2550,10,0,0.0,1.9,40,835,1335,2170,0.850980392
423001,116,17,306,578,884,12,0,0.0,1.3333334,15,-499,1331,832,0.941176471
423001,116,17,306,578,884,12,0,0.0,2.3333333,15,176,652,828,0.936651584
423002,116,17,306,578,884,12,0,0.0,0.25,14,233,549,782,0.884615385
423002,116,17,306,578,884,12,0,0.0,1.25,13,130,622,752,0.850678733
423003,116,17,306,578,884,12,0,0.0,0.0,11,255,351,606,0.685520362
423003,116,17,306,578,884,12,0,0.0,1.0,14,230,590,820,0.92760181
423004,116,17,306,578,884,12,0,0.0,0.0,13,162,578,740,0.837104072
423004,116,17,306,578,884,12,0,0.0,1.0,12,-151,837,686,0.7760181
425001,115,18,324,324,648,27,0,0.0,0.0,20,258,338,596,0.919753086
425001,115,18,324,324,648,27,0,0.0,1.0,23,306,254,560,0.864197531
425001,115,18,324,324,648,27,0,0.0,2.0,21,302,274,576,0.888888889
427001,118,14,602,497,1099,10,0,0.3,0.7,13,389,669,1058,0.962693358
428001,78,13,312,156,468,10,0,0.2,10.3,4,42,190,232,0.495726496
428001,78,13,312,156,468,10,0,0.2,11.3,3,35,135,170,0.363247863
428002,78,13,312,156,468,10,0,1.2,10.6,5,100,140,240,0.512820513
428002,78,13,312,156,468,10,0,1.2,11.6,4,46,162,208,0.444444444
428003,78,13,312,156,468,10,0,1.2,10.1,6,-27,317,290,0.61965812
428003,78,13,312,156,468,10,0,1.2,11.1,2,18,92,110,0.235042735
428004,75,6,174,84,258,5,0,1.2,8.2,2,48,78,126,0.488372093
429001,108,9,198,270,468,10,0,1.0,9.8,6,140,160,300,0.641025641
429001,108,9,198,270,468,10,0,1.0,10.8,9,245,194,439,0.938034188
429002,108,9,198,270,468,10,0,2.5,9.5,6,162,106,268,0.572649573
429002,108,9,198,270,468,10,0,2.5,10.5,10,152,259,411,0.878205128
431001,659,9,2142,1098,3240,10,0,0.4,3.1,11,1300,1387,2687,0.829320988
431002,659,9,2142,1098,3240,10,0,0.5,3.1,9,2030,786,2816,0.869135802
431003,659,9,2142,1098,3240,10,0,0.7,2.6,11,2147,568,2715,0.837962963
431004,659,9,2142,1098,3240,10,0,0.1,4.1,11,2313,288,2601,0.802777778
431005,659,9,2142,1098,3240,10,0,0.5,4.0,8,1760,1118,2878,0.888271605
431006,659,9,2142,1098,3240,10,0,0.6,3.9,10,1576,577,2153,0.664506173
431007,659,9,2142,1098,3240,10,0,0.0,4.2,9,2735,449,3184,0.982716049
431008,659,9,2142,1098,3240,10,0,0.6,3.1,12,255,2168,2423,0.747839506
432001,112,13,260,416,676,10,1,0.0,0.0,11,333,281,614,0.908284024
432002,112,13,260,416,676,10,1,0.0,0.0,12,596,-15,581,0.859467456
432003,112,13,260,416,676,10,1,0.0,0.0,10,61,457,518,0.766272189
433001,112,9,180,288,468,6,0,0.0,5.0,7,70,364,434,0.927350427
436001,110,13,234,390,624,10,0,0.0,0.0,11,-72,640,568,0.91025641
436002,110,13,234,390,624,10,0,0.0,0.0,7,97,263,360,0.576923077
436004,110,13,234,390,624,10,0,0.0,0.0,10,350,176,526,0.842948718
436005,110,13,234,390,624,10,0,0.0,0.5,14,-11,624,613,0.982371795
438001,112,13,260,416,676,10,1,0.0,0.0,11,350,266,616,0.911242604
438002,112,13,260,416,676,10,1,0.0,0.0,11,295,273,568,0.840236686
439001,80,15,435,435,870,31,0,0.0,11.4838705,11,337,310,647,0.743678161
439001,80,15,435,435,870,31,0,0.0,12.4838705,12,453,267,720,0.827586207
439001,80,15,435,435,870,31,0,0.0,13.4838705,13,514,270,784,0.901149425
439001,80,15,435,435,870,31,0,0.0,14.4838705,12,499,233,732,0.84137931
440001,112,13,260,416,676,10,1,0.1,0.9,13,170,489,659,0.974852071
440002,112,13,260,416,676,10,1,0.0,1.0,10,146,425,571,0.844674556
440003,112,13,260,416,676,10,1,0.0,1.0,14,382,285,667,0.986686391
440004,112,13,260,416,676,10,1,0.0,1.0,14,321,329,650,0.961538462
441001,550,15,3750,3750,7500,20,0,0.0,0.0,21,2413,2687,5100,0.68
441002,550,15,3750,3750,7500,20,0,0.0,0.0,25,6746,-6246,500,0.066666667
441003,550,15,3750,3750,7500,20,0,0.0,0.0,21,4192,8,4200,0.56
441004,550,15,3750,3750,7500,20,0,0.0,0.0,24,4722,-1522,3200,0.426666667
441005,550,15,3750,3750,7500,20,0,0.0,0.0,22,-84,2984,2900,0.386666667
441006,550,15,3750,3750,7500,20,0,0.0,0.0,21,-775,2675,1900,0.253333333
441007,550,15,3750,3750,7500,20,0,0.0,0.0,20,1521,-521,1000,0.133333333
441008,550,15,3750,3750,7500,20,0,0.0,0.0,20,5714,-514,5200,0.693333333
441009,550,15,3750,3750,7500,20,0,0.0,0.0,19,3525,1575,5100,0.68
442001,112,13,260,416,676,10,1,0.0,3.0,13,249,385,634,0.937869822
442002,112,13,260,416,676,10,1,0.0,2.4,13,398,263,661,0.977810651
442003,112,13,260,416,676,10,1,0.0,2.4,13,150,464,614,0.908284024
442004,112,13,260,416,676,10,1,0.0,2.4,14,308,350,658,0.973372781
442005,112,13,260,416,676,10,1,0.1,2.3,14,21,641,662,0.979289941
442006,112,13,260,416,676,10,1,0.0,3.0,13,-36,678,642,0.949704142
442007,112,13,260,416,676,10,1,0.2,2.8,13,565,97,662,0.979289941
442008,112,13,260,416,676,10,1,0.1,2.7,12,460,135,595,0.880177515
442009,112,13,260,416,676,10,1,0.0,2.5,14,465,190,655,0.968934911
442010,112,13,260,416,676,10,1,0.2,2.8,14,437,216,653,0.965976331
442011,112,13,260,416,676,10,1,0.2,2.6,13,263,396,659,0.974852071
442012,112,13,260,416,676,10,1,0.0,2.7,13,375,267,642,0.949704142
442013,112,13,260,416,676,10,1,0.0,3.0,13,516,126,642,0.949704142
442014,112,13,260,416,676,10,1,0.2,2.8,10,271,239,510,0.75443787
442015,112,13,260,416,676,10,1,0.1,2.9,13,320,345,665,0.983727811
442016,112,13,260,416,676,10,1,0.0,2.7,14,-466,1116,650,0.961538462
442017,112,13,260,416,676,10,1,0.0,2.7,14,288,360,648,0.958579882
442018,112,13,260,416,676,10,1,0.0,3.0,13,242,388,630,0.931952663
442019,112,13,260,416,676,10,1,0.0,3.0,14,-364,1036,672,0.99408284
442020,112,13,260,416,676,10,1,0.0,3.0,15,500,160,660,0.976331361
442021,112,13,260,416,676,10,1,0.0,3.0,12,165,456,621,0.918639053
442022,112,13,260,416,676,10,1,0.0,2.7,11,60,518,578,0.855029586
442023,112,13,260,416,676,10,1,0.0,2.4,12,56,578,634,0.937869822
442024,112,13,260,416,676,10,1,0.0,2.7,14,60,588,648,0.958579882
442025,112,13,260,416,676,10,1,0.0,2.7,12,348,300,648,0.958579882
442026,112,13,260,416,676,10,1,0.0,2.6,15,254,406,660,0.976331361
442027,112,13,260,416,676,10,1,0.0,2.7,15,447,213,660,0.976331361
442028,112,13,260,416,676,10,1,0.0,3.0,13,484,137,621,0.918639053
442029,112,13,260,416,676,10,1,0.0,2.8,11,458,110,568,0.840236686
442030,112,13,260,416,676,10,1,0.0,2.5,14,177,492,669,0.98964497
442031,112,13,260,416,676,10,1,0.3,2.2,12,340,275,615,0.909763314
442032,112,13,260,416,676,10,1,0.2,2.8,14,488,175,663,0.980769231
442033,112,13,260,416,676,10,1,0.1,2.6,12,220,371,591,0.874260355
442035,112,13,260,416,676,10,1,0.0,2.2,9,193,275,468,0.692307692
443001,65,13,780,390,1170,10,0,0.5,5.2,11,233,832,1065,0.91025641
443001,65,13,780,390,1170,10,0,0.5,6.2,9,392,493,885,0.756410256
443002,65,13,780,390,1170,10,0,0.7,5.7,12,569,411,980,0.837606838
443002,65,13,780,390,1170,10,0,0.7,6.7,12,884,151,1035,0.884615385
443003,60,11,725,330,1055,9,0,1.3333334,5.111111,10,110,760,870,0.82464455
443003,65,13,780,390,1170,10,0,1.3,5.9,12,279,831,1110,0.948717949
444001,112,13,260,416,676,10,1,0.6,1.4,9,286,255,541,0.800295858
444002,112,13,260,416,676,10,1,0.6,1.2,11,305,299,604,0.893491124
444003,112,13,260,416,676,10,1,0.0,1.8,7,25,417,442,0.653846154
444004,112,13,260,416,676,10,1,0.2,1.7,10,233,355,588,0.869822485
446001,78,13,312,156,468,10,0,1.7,9.1,12,126,320,446,0.952991453
446001,78,13,312,156,468,10,0,1.7,10.1,14,222,234,456,0.974358974
446002,78,13,312,156,468,10,0,1.3,7.7,10,173,253,426,0.91025641
446002,78,13,312,156,468,10,0,1.3,8.7,12,309,153,462,0.987179487
446003,78,13,312,156,468,10,0,1.3,7.8,10,62,346,408,0.871794872
446003,78,13,312,156,468,10,0,1.3,8.8,10,68,324,392,0.837606838
449001,95,10,135,225,360,10,0,0.1,0.4,11,192,102,294,0.816666667
449002,95,10,135,225,360,10,0,0.0,0.0,9,141,177,318,0.883333333
450001,96,10,155,235,390,10,0,0.5,2.5,7,230,56,286,0.733333333
450001,96,10,155,235,390,10,0,0.5,3.5,5,85,65,150,0.384615385
450002,96,10,155,235,390,10,0,0.2,2.5,6,67,196,263,0.674358974
450002,96,10,155,235,390,10,0,0.2,3.5,4,20,82,102,0.261538462
450003,96,10,155,235,390,10,0,0.5,2.5,9,179,111,290,0.743589744
450003,96,10,155,235,390,10,0,0.5,3.5,3,57,33,90,0.230769231
450004,96,10,155,235,390,10,0,0.6,2.4,7,169,102,271,0.694871795
450004,96,10,155,235,390,10,0,0.6,3.4,4,21,87,108,0.276923077
450005,96,10,155,235,390,10,0,0.8,2.3,9,157,154,311,0.797435897
450005,96,10,155,235,390,10,0,0.8,3.3,7,155,121,276,0.707692308
451001,96,7,210,266,476,10,0,0.0,0.0,5,191,136,327,0.68697479
451002,96,7,210,266,476,10,0,0.0,0.0,6,172,223,395,0.829831933
451003,96,7,210,266,476,10,0,0.0,0.0,7,129,270,399,0.838235294
451004,96,7,210,266,476,10,0,0.0,0.0,6,138,199,337,0.707983193
451005,96,7,210,266,476,10,0,0.0,0.0,4,200,110,310,0.651260504
451006,96,7,210,266,476,10,0,0.0,0.0,6,48,335,383,0.804621849
451007,96,7,210,266,476,10,0,0.0,0.0,8,320,105,425,0.892857143
451008,96,7,210,266,476,10,0,0.0,0.0,5,-264,619,355,0.745798319
451009,96,7,210,266,476,10,0,0.0,0.0,8,133,265,398,0.836134454
451010,96,7,210,266,476,10,0,0.0,0.0,8,235,179,414,0.869747899
451011,96,7,210,266,476,10,0,0.0,0.0,6,-127,510,383,0.804621849
451012,96,7,210,266,476,10,0,0.0,0.0,7,313,18,331,0.695378151
451013,96,7,210,266,476,10,0,0.0,0.0,5,-21,342,321,0.674369748
451014,96,7,210,266,476,10,0,0.0,0.0,7,53,299,352,0.739495798
451015,96,7,210,266,476,10,0,0.0,0.0,8,317,97,414,0.869747899
451016,96,7,210,266,476,10,0,0.0,0.0,8,192,211,403,0.846638655
451017,96,7,210,266,476,10,0,0.0,0.0,3,132,52,184,0.386554622
451018,96,7,210,266,476,10,0,0.0,0.0,5,86,290,376,0.789915966
451019,96,7,210,266,476,10,0,0.0,0.0,9,55,356,411,0.863445378
451020,96,7,210,266,476,10,0,0.0,0.0,6,282,167,449,0.943277311
451021,96,7,210,266,476,10,0,0.0,0.0,8,87,351,438,0.920168067
451022,96,7,210,266,476,10,0,0.0,0.0,7,132,309,441,0.926470588
451023,96,7,210,266,476,10,0,0.0,0.0,5,225,118,343,0.720588235
451024,96,7,210,266,476,10,0,0.0,0.0,7,132,241,373,0.783613445
452001,112,13,260,416,676,10,1,0.0,0.0,11,321,308,629,0.930473373
452002,112,13,260,416,676,10,1,0.0,0.0,12,248,374,622,0.920118343
452003,112,13,260,416,676,10,1,0.0,0.0,12,234,414,648,0.958579882
452004,112,13,260,416,676,10,1,0.0,0.0,8,148,365,513,0.75887574
453001,550,3,750,600,1350,9,0,0.0,5.0,3,1140,210,1350,1.0
456001,112,13,260,416,676,10,1,0.0,0.0,11,335,277,612,0.905325444
456002,112,13,260,416,676,10,1,0.0,0.0,13,401,265,666,0.985207101
456003,112,13,260,416,676,10,1,0.0,0.0,13,319,341,660,0.976331361
456004,112,13,260,416,676,10,1,0.0,0.0,12,279,325,604,0.893491124
456005,112,13,260,416,676,10,1,0.0,0.5,10,94,469,563,0.832840237
457001,112,13,260,416,676,10,1,0.0,1.0,11,649,-59,590,0.872781065
457002,112,13,260,416,676,10,1,0.0,1.0,12,275,341,616,0.911242604
457003,110,3,75,105,180,2,0,0.0,0.0,2,185,-25,160,0.888888889
458001,115,13,624,455,1079,10,0,0.6,2.4,11,479,485,964,0.893419833
458001,115,13,624,455,1079,10,0,0.6,3.4,12,682,343,1025,0.949953661
458002,115,13,624,455,1079,10,0,0.3,2.7,13,359,700,1059,0.981464319
458002,115,13,624,455,1079,10,0,0.3,3.7,14,496,570,1066,0.987951807
458003,115,13,624,455,1079,10,0,1.2,1.8,12,655,279,934,0.865616311
458003,115,13,624,455,1079,10,0,1.2,2.8,10,564,314,878,0.813716404
458004,115,13,624,455,1079,10,0,1.8,1.2,10,424,442,866,0.802594995
458004,115,13,624,455,1079,10,0,1.8,2.2,11,587,364,951,0.88137164
459001,102,30,754,853,1607,22,0,0.0,0.6818182,27,793,581,1374,0.855009334
459001,102,30,754,853,1607,22,0,0.0,1.6818181,28,1034,391,1425,0.886745488
459001,102,30,754,853,1607,22,0,0.0,2.6818182,26,999,422,1421,0.884256378
459001,102,30,754,853,1607,22,0,0.0,3.6818182,27,924,537,1461,0.90914748
459001,102,30,754,853,1607,22,0,0.0,4.681818,28,987,485,1472,0.915992533
460001,112,13,260,416,676,10,1,0.0,0.0,12,530,37,567,0.838757396
460001,112,13,260,416,676,10,1,0.0,1.0,10,357,210,567,0.838757396
460002,112,13,260,416,676,10,1,0.0,0.0,15,401,259,660,0.976331361
460002,112,13,260,416,676,10,1,0.0,1.0,13,453,209,662,0.979289941
460003,112,13,260,416,676,10,1,0.0,0.0,12,315,298,613,0.906804734
460003,112,13,260,416,676,10,1,0.0,1.0,10,218,352,570,0.843195266
463001,113,27,648,999,1647,18,0,0.0,0.0,25,442,1112,1554,0.943533698
465001,130,11,1265,495,1760,10,0,0.6,2.4,13,300,1346,1646,0.935227273
465002,130,11,1265,495,1760,10,0,0.9,2.1,13,1125,570,1695,0.963068182
466001,112,13,260,416,676,10,1,0.0,0.0,13,564,107,671,0.99260355
466002,112,13,260,416,676,10,1,0.0,0.0,11,703,-101,602,0.890532544
467001,110,11,220,330,550,10,0,0.0,1.0,10,235,219,454,0.825454545
467002,110,11,220,330,550,10,0,0.0,1.0,12,143,373,516,0.938181818
467003,110,11,220,330,550,10,0,0.0,0.8,9,205,217,422,0.767272727
467004,110,11,220,330,550,10,0,0.0,1.0,11,209,301,510,0.927272727
467005,110,11,220,330,550,10,0,0.0,0.8,10,289,171,460,0.836363636
467006,95,3,105,99,204,3,0,0.0,0.6666667,2,65,73,138,0.676470588
468001,97,48,951,1128,2079,44,0,0.0,0.0,40,969,652,1621,0.77970178
468001,97,48,951,1128,2079,44,0,0.0,1.0,51,891,994,1885,0.906685907
468001,97,48,951,1128,2079,44,0,0.0,2.0,54,868,932,1800,0.865800866
468001,97,48,951,1128,2079,44,0,0.0,3.0,56,841,1092,1933,0.92977393
468002,97,46,920,1098,2018,42,0,0.0,0.0,32,408,932,1340,0.664023786
468002,97,46,920,1098,2018,42,0,0.0,1.0,48,524,1187,1711,0.847869177
468002,97,46,920,1098,2018,42,0,0.0,2.0,47,930,919,1849,0.916253717
468002,97,46,920,1098,2018,42,0,0.0,3.0,48,669,1158,1827,0.905351833
471001,102,10,290,233,523,10,0,0.0,0.0,9,291,196,487,0.931166348
471001,108,10,170,300,470,10,0,0.0,1.0,8,345,105,450,0.957446809
472001,96,7,198,169,367,15,0,0.0,1.0,7,352,8,360,0.980926431
473001,112,13,260,416,676,10,1,0.0,0.8,13,248,372,620,0.917159763
473002,112,13,260,416,676,10,1,0.0,0.9,13,514,116,630,0.931952663
473003,112,13,260,416,676,10,1,0.0,0.0,12,165,411,576,0.852071006
473004,112,13,260,416,676,10,1,0.0,0.0,12,365,214,579,0.856508876
473005,112,13,260,416,676,10,1,0.0,0.8,15,332,328,660,0.976331361
473006,112,13,260,416,676,10,1,0.0,0.0,10,253,310,563,0.832840237
473007,112,13,260,416,676,10,1,0.0,0.4,12,152,430,582,0.860946746
473008,112,13,260,416,676,10,1,0.0,1.2,14,244,396,640,0.946745562
473009,112,13,260,416,676,10,1,0.0,1.2,12,179,441,620,0.917159763
473010,112,13,260,416,676,10,1,0.0,1.0,14,214,426,640,0.946745562
473011,112,13,260,416,676,10,1,0.0,0.9,12,327,286,613,0.906804734
473012,101,6,195,201,396,5,0,0.0,1.0,6,218,158,376,0.949494949
474001,89,19,1083,399,1482,18,0,0.0,0.0,17,491,733,1224,0.825910931
476001,65,13,780,390,1170,10,0,0.2,4.8,8,137,673,810,0.692307692
476001,65,13,780,390,1170,10,0,0.2,5.8,11,522,613,1135,0.97008547
476002,65,13,780,390,1170,10,0,0.0,5.0,10,390,585,975,0.833333333
476002,65,13,780,390,1170,10,0,0.0,6.0,14,402,753,1155,0.987179487
476003,65,11,670,335,1005,8,0,0.25,3.75,4,213,337,550,0.547263682
476003,65,13,780,390,1170,10,0,0.2,4.8,10,454,406,860,0.735042735
476004,70,3,195,120,315,2,0,1.0,4.0,1,85,95,180,0.571428571
477001,112,13,260,416,676,10,1,0.1,0.7,14,288,371,659,0.974852071
477002,112,13,260,416,676,10,1,0.1,0.3,12,380,240,620,0.917159763
477003,112,13,260,416,676,10,1,0.0,0.0,12,449,128,577,0.853550296
477004,112,13,260,416,676,10,1,0.1,0.3,13,-579,1197,618,0.914201183
477005,112,13,260,416,676,10,1,0.0,0.0,13,470,176,646,0.955621302
477006,112,13,260,416,676,10,1,0.0,0.1,13,15,599,614,0.908284024
477008,110,3,75,105,180,2,0,0.0,0.0,1,52,48,100,0.555555556
478001,115,30,585,1026,1611,21,0,0.0,1.0,29,-198,1764,1566,0.972067039
479001,112,13,260,416,676,10,1,0.0,0.0,14,274,384,658,0.973372781
481001,110,65,1504,2064,3568,50,0,0.0,0.0,68,1758,1491,3249,0.91059417
481001,110,65,1504,2064,3568,50,0,0.0,1.0,65,1049,2268,3317,0.929652466
481002,110,65,1504,2064,3568,50,0,0.0,0.0,58,1578,1477,3055,0.856221973
481002,110,65,1504,2064,3568,50,0,0.0,1.0,65,1255,1853,3108,0.871076233
481003,110,65,1504,2064,3568,50,0,0.0,0.0,66,1321,2018,3339,0.935818386
481003,110,65,1504,2064,3568,50,0,0.0,1.0,65,1524,1619,3143,0.88088565
481004,111,60,1376,1912,3288,46,0,0.0,0.0,52,1682,1153,2835,0.862226277
481004,111,60,1376,1912,3288,46,0,0.0,1.0,55,1208,1491,2699,0.820863747
482001,120,29,1218,1218,2436,59,0,0.0,2.9491525,27,1135,1111,2246,0.922003284
482001,120,29,1218,1218,2436,59,0,0.0,3.9491525,28,843,1483,2326,0.954844007
482001,120,29,1218,1218,2436,59,0,0.0,4.9491525,26,1251,823,2074,0.851395731
482002,120,2,138,138,276,4,0,0.0,3.0,1,90,46,136,0.492753623
482002,120,3,204,204,408,6,0,0.0,3.1666667,2,156,116,272,0.666666667
483001,120,36,1260,1260,2520,76,0,0.0,0.0,32,717,1587,2304,0.914285714
483001,120,36,1260,1260,2520,76,0,0.0,1.0,33,531,1763,2294,0.91031746
483001,120,36,1260,1260,2520,76,0,0.0,2.0,35,1034,1322,2356,0.934920635
484001,100,15,345,430,775,10,0,0.0,0.4,11,225,432,657,0.847741935
484001,100,15,345,430,775,10,0,0.0,1.4,14,269,498,767,0.989677419
484001,100,15,345,430,775,10,0,0.0,2.4,14,113,655,768,0.990967742
484001,100,15,345,430,775,10,0,0.0,3.4,14,187,580,767,0.989677419
484001,100,15,345,430,775,10,0,0.0,4.4,14,158,608,766,0.988387097
485001,100,1,50,50,100,2,0,0.0,1.5,1,29,71,100,1.0
486001,100,25,650,650,1300,11,0,0.0,2.0,25,535,713,1248,0.96
486001,100,25,650,650,1300,11,0,0.0,3.0,25,519,761,1280,0.984615385
486001,100,25,650,650,1300,11,0,0.0,4.0,8,303,327,630,0.484615385
486002,100,25,650,650,1300,11,0,0.0,1.6363636,22,936,302,1238,0.952307692
486002,100,25,650,650,1300,11,0,0.0,2.6363637,21,975,193,1168,0.898461538
486002,100,25,650,650,1300,11,0,0.0,3.6363637,7,397,147,544,0.418461538
487001,100,39,1209,1209,2418,27,0,0.0,0.0,36,988,1253,2241,0.926799007
489001,101,52,1369,1326,2695,37,0,0.0,0.0,48,1099,1401,2500,0.927643785
490001,112,13,260,416,676,10,1,0.0,9.9,12,280,357,637,0.942307692
490002,112,13,260,416,676,10,1,0.0,8.6,10,55,558,613,0.906804734
490003,112,11,223,357,580,8,0,0.0,10.25,8,-99,616,517,0.89137931
492001,112,13,260,416,676,10,1,0.0,0.0,9,247,305,552,0.816568047
492001,112,13,260,416,676,10,1,0.0,1.0,10,315,170,485,0.717455621
492001,112,13,260,416,676,10,1,0.0,2.0,12,320,296,616,0.911242604
492002,112,13,260,416,676,10,1,0.0,0.0,8,262,239,501,0.74112426
492002,112,13,260,416,676,10,1,0.0,1.0,13,336,335,671,0.99260355
492002,112,13,260,416,676,10,1,0.0,2.0,13,268,392,660,0.976331361
492003,112,13,260,416,676,10,1,0.0,0.3,7,164,314,478,0.707100592
492003,112,13,260,416,676,10,1,0.0,1.3,9,418,162,580,0.857988166
492003,112,13,260,416,676,10,1,0.0,2.3,9,217,344,561,0.829881657
492004,112,13,260,416,676,10,1,0.0,0.0,5,170,193,363,0.536982249
492004,112,13,260,416,676,10,1,0.0,1.0,13,162,497,659,0.974852071
492004,112,13,260,416,676,10,1,0.0,2.0,12,297,343,640,0.946745562
492005,112,13,260,416,676,10,1,0.0,0.0,8,37,503,540,0.798816568
492005,112,13,260,416,676,10,1,0.0,1.0,12,-22,655,633,0.936390533
492005,112,13,260,416,676,10,1,0.0,2.0,10,271,306,577,0.853550296
492006,112,13,260,416,676,10,1,0.0,0.0,7,252,224,476,0.704142012
492006,112,13,260,416,676,10,1,0.0,1.0,11,180,457,637,0.942307692
492006,112,13,260,416,676,10,1,0.0,2.0,13,247,396,643,0.951183432
492007,112,13,260,416,676,10,1,0.0,0.0,9,241,282,523,0.773668639
492007,112,13,260,416,676,10,1,0.0,1.0,10,-16,559,543,0.803254438
492007,112,13,260,416,676,10,1,0.0,2.0,12,429,166,595,0.880177515
492008,112,13,260,416,676,10,1,0.0,0.5,8,11,453,464,0.686390533
492008,112,13,260,416,676,10,1,0.0,1.5,8,107,410,517,0.764792899
492008,112,13,260,416,676,10,1,0.0,2.5,12,-85,688,603,0.892011834
492009,112,13,260,416,676,10,1,0.0,0.0,8,427,127,554,0.819526627
492009,112,13,260,416,676,10,1,0.0,1.0,9,201,324,525,0.776627219
492009,112,13,260,416,676,10,1,0.0,2.0,9,243,306,549,0.812130178
492010,112,13,260,416,676,10,1,0.0,0.0,6,174,251,425,0.628698225
492010,112,13,260,416,676,10,1,0.0,1.0,10,86,496,582,0.860946746
492010,112,13,260,416,676,10,1,0.0,2.0,10,315,253,568,0.840236686
492011,112,13,260,416,676,10,1,0.0,0.0,7,80,425,505,0.74704142
492011,112,13,260,416,676,10,1,0.0,1.0,9,232,294,526,0.778106509
492011,112,13,260,416,676,10,1,0.0,2.0,8,170,271,441,0.652366864
492012,112,13,260,416,676,10,1,0.0,0.0,3,23,176,199,0.294378698
492012,112,13,260,416,676,10,1,0.0,1.0,11,392,209,601,0.889053254
492012,112,13,260,416,676,10,1,0.0,2.0,10,148,359,507,0.75
492013,112,13,260,416,676,10,1,0.0,0.0,5,119,271,390,0.576923077
492013,112,13,260,416,676,10,1,0.0,1.0,9,270,336,606,0.896449704
492013,112,13,260,416,676,10,1,0.0,2.0,11,150,393,543,0.803254438
492014,112,13,260,416,676,10,1,0.0,0.0,9,309,228,537,0.794378698
492014,112,13,260,416,676,10,1,0.0,1.0,12,365,220,585,0.865384615
492014,112,13,260,416,676,10,1,0.0,2.0,11,628,0,628,0.928994083
492015,112,13,260,416,676,10,1,0.0,0.0,6,-38,445,407,0.602071006
492015,112,13,260,416,676,10,1,0.0,1.0,12,43,592,635,0.939349112
492015,112,13,260,416,676,10,1,0.0,2.0,11,79,551,630,0.931952663
492016,112,13,260,416,676,10,1,0.0,0.5,4,199,93,292,0.431952663
492016,112,13,260,416,676,10,1,0.0,1.5,11,361,219,580,0.857988166
492016,112,13,260,416,676,10,1,0.0,2.5,8,305,184,489,0.723372781
492017,112,13,260,416,676,10,1,0.0,0.0,4,58,268,326,0.482248521
492017,112,13,260,416,676,10,1,0.0,1.0,9,93,412,505,0.74704142
492017,112,13,260,416,676,10,1,0.0,2.0,10,34,432,466,0.689349112
492018,112,13,260,416,676,10,1,0.0,0.0,7,233,199,432,0.639053254
492018,112,13,260,416,676,10,1,0.0,1.0,12,291,360,651,0.963017751
492018,112,13,260,416,676,10,1,0.0,2.0,12,244,365,609,0.900887574
492019,112,13,260,416,676,10,1,0.0,0.0,11,172,414,586,0.866863905
492019,112,13,260,416,676,10,1,0.0,1.0,10,89,523,612,0.905325444
492019,112,13,260,416,676,10,1,0.0,2.0,11,112,466,578,0.855029586
492020,112,13,260,416,676,10,1,0.0,0.0,7,341,99,440,0.650887574
492020,112,13,260,416,676,10,1,0.0,1.0,11,370,258,628,0.928994083
492020,112,13,260,416,676,10,1,0.0,2.0,9,355,169,524,0.775147929
492021,112,13,260,416,676,10,1,0.0,0.0,7,323,103,426,0.630177515
492021,112,13,260,416,676,10,1,0.0,1.0,9,199,239,438,0.647928994
492021,112,13,260,416,676,10,1,0.0,2.0,8,229,259,488,0.721893491
492022,112,13,260,416,676,10,1,0.0,0.0,6,-52,411,359,0.531065089
492022,112,13,260,416,676,10,1,0.0,1.0,12,13,640,653,0.965976331
492022,112,13,260,416,676,10,1,0.0,2.0,13,189,445,634,0.937869822
492023,112,13,260,416,676,10,1,0.0,0.0,6,-5,371,366,0.541420118
492023,112,13,260,416,676,10,1,0.0,1.0,13,472,184,656,0.970414201
492023,112,13,260,416,676,10,1,0.0,2.0,12,227,388,615,0.909763314
492024,112,13,260,416,676,10,1,0.0,0.0,6,35,317,352,0.520710059
492024,112,13,260,416,676,10,1,0.0,1.0,8,211,223,434,0.642011834
492024,112,13,260,416,676,10,1,0.0,2.0,11,2,602,604,0.893491124
492025,112,13,260,416,676,10,1,0.0,0.0,5,-51,374,323,0.477810651
492025,112,13,260,416,676,10,1,0.0,1.0,10,-144,658,514,0.76035503
492025,112,13,260,416,676,10,1,0.0,2.0,11,179,419,598,0.884615385
492027,97,3,114,111,225,3,0,0.0,0.0,2,165,15,180,0.8
492027,97,3,114,111,225,3,0,0.0,1.0,2,59,91,150,0.666666667
493001,118,14,602,497,1099,10,0,0.3,1.7,14,282,791,1073,0.976342129
494001,103,18,450,420,870,15,0,3.7333333,0.0,5,-149,471,322,0.370114943
495001,102,38,1083,1093,2176,29,0,0.0,0.2413793,37,642,1351,1993,0.915900735
495001,102,38,1083,1093,2176,29,0,0.0,1.2413793,34,623,1378,2001,0.919577206
495001,102,38,1083,1093,2176,29,0,0.0,2.2413793,34,860,1067,1927,0.885569853
495001,102,38,1083,1093,2176,29,0,0.0,3.2413793,33,609,1236,1845,0.847886029
495001,102,38,1083,1093,2176,29,0,0.0,4.2413793,36,727,1193,1920,0.882352941
499001,107,4,100,126,226,10,0,0.0,4.9,3,79,93,172,0.761061947
499001,107,4,100,126,226,10,0,0.0,11.8,3,65,107,172,0.761061947
499001,107,4,100,126,226,10,0,0.0,12.8,3,76,96,172,0.761061947
499002,107,4,100,126,226,10,0,0.0,5.9,4,-83,297,214,0.946902655
499002,107,4,100,126,226,10,0,0.0,12.5,5,111,99,210,0.92920354
499002,107,4,100,126,226,10,0,0.0,13.5,1,37,51,88,0.389380531
499003,107,4,100,126,226,10,0,0.0,5.3,4,11,162,173,0.765486726
499003,107,4,100,126,226,10,0,0.0,11.7,2,75,45,120,0.530973451
499003,107,4,100,126,226,10,0,0.0,12.7,3,105,108,213,0.942477876
499004,107,4,100,126,226,10,0,0.0,5.1,4,54,172,226,1.0
499004,107,4,100,126,226,10,0,0.0,11.9,3,99,61,160,0.707964602
499004,107,4,100,126,226,10,0,0.0,12.9,3,118,78,196,0.867256637
499005,107,4,100,126,226,10,0,0.0,9.5,3,62,139,201,0.889380531
499005,107,4,100,126,226,10,0,0.0,10.5,2,19,87,106,0.469026549
499005,107,4,100,126,226,10,0,0.0,11.5,4,-149,324,175,0.774336283
499006,100,1,50,50,100,2,0,0.0,9.5,1,80,20,100,1.0
500001,107,15,330,435,765,11,0,0.0,0.18181819,12,58,580,638,0.833986928
500001,107,15,330,435,765,11,0,0.0,1.1818181,15,241,500,741,0.968627451
500001,107,15,330,435,765,11,0,0.0,2.1818182,14,371,352,723,0.945098039
500001,107,15,330,435,765,11,0,0.0,3.1818182,13,394,325,719,0.939869281
500001,107,15,330,435,765,11,0,0.0,4.181818,13,377,334,711,0.929411765
500001,107,15,330,435,765,11,0,0.0,5.181818,14,456,281,737,0.963398693
500001,107,15,330,435,765,11,0,0.0,6.181818,14,526,215,741,0.968627451
500001,107,15,330,435,765,11,0,0.0,7.181818,15,547,206,753,0.984313725
500002,110,14,287,424,711,10,0,0.0,0.1,10,327,249,576,0.810126582
503001,112,13,260,416,676,10,1,0.1,0.9,13,100,563,663,0.980769231
503001,112,13,260,416,676,10,1,0.1,1.9,11,371,247,618,0.914201183
503002,112,13,260,416,676,10,1,0.2,0.8,12,198,451,649,0.960059172
503002,112,13,260,416,676,10,1,0.2,1.8,11,129,504,633,0.936390533
503003,112,13,260,416,676,10,1,0.4,0.6,12,243,388,631,0.933431953
503003,112,13,260,416,676,10,1,0.4,1.6,14,179,481,660,0.976331361
504001,100,51,1275,1275,2550,40,0,0.0,0.0,40,814,1385,2199,0.862352941
505001,73,18,495,189,684,12,0,1.1666666,5.8333335,10,425,113,538,0.786549708
505001,73,18,495,189,684,12,0,1.1666666,6.8333335,11,444,101,545,0.796783626
505002,73,18,495,189,684,12,0,1.1666666,5.25,8,370,76,446,0.652046784
505002,73,18,495,189,684,12,0,1.1666666,6.25,10,530,-8,522,0.763157895
506001,78,13,312,156,468,10,0,0.0,0.0,11,-659,1065,406,0.867521368
506001,78,13,312,156,468,10,0,0.0,1.0,11,-169,585,416,0.888888889
506002,78,13,312,156,468,10,0,0.0,0.0,12,-468,884,416,0.888888889
506002,78,13,312,156,468,10,0,0.0,1.0,11,-263,665,402,0.858974359
506003,78,13,312,156,468,10,0,0.0,0.0,13,223,233,456,0.974358974
506003,78,13,312,156,468,10,0,0.0,1.0,11,325,69,394,0.841880342
506004,78,13,312,156,468,10,0,0.0,0.0,7,114,146,260,0.555555556
506004,78,13,312,156,468,10,0,0.0,1.0,11,170,264,434,0.927350427
506005,78,13,312,156,468,10,0,0.2,0.2,11,-28,462,434,0.927350427
506005,78,13,312,156,468,10,0,0.2,1.2,10,-206,628,422,0.901709402
506006,78,13,312,156,468,10,0,0.0,0.2,13,253,197,450,0.961538462
506006,78,13,312,156,468,10,0,0.0,1.2,12,155,279,434,0.927350427
507001,501,150,33450,33600,67050,150,0,0.0,0.10666667,195,38838,16930,55768,0.831737509
507001,501,150,33450,33600,67050,150,0,0.0,1.1066667,22,8141,4417,12558,0.187293065
508001,112,13,260,416,676,10,1,0.0,0.3,9,71,497,568,0.840236686
508001,112,13,260,416,676,10,1,0.0,1.3,11,135,451,586,0.866863905
508002,112,13,260,416,676,10,1,0.0,0.0,10,341,243,584,0.863905325
508002,112,13,260,416,676,10,1,0.0,1.0,12,413,220,633,0.936390533
508003,112,13,260,416,676,10,1,0.0,0.0,9,234,282,516,0.763313609
508003,112,13,260,416,676,10,1,0.0,1.0,13,347,326,673,0.99556213
508004,112,13,260,416,676,10,1,0.0,0.0,13,104,494,598,0.884615385
508004,112,13,260,416,676,10,1,0.0,1.0,8,200,265,465,0.687869822
509001,96,10,155,235,390,10,0,0.1,0.9,10,-131,459,328,0.841025641
509001,96,10,155,235,390,10,0,0.1,1.9,12,192,148,340,0.871794872
509002,96,10,155,235,390,10,0,0.0,1.0,10,96,234,330,0.846153846
509002,96,10,155,235,390,10,0,0.0,2.0,11,185,148,333,0.853846154
509003,96,10,155,235,390,10,0,0.3,0.7,9,-51,380,329,0.843589744
509003,96,10,155,235,390,10,0,0.3,1.7,11,-43,332,289,0.741025641
509004,95,8,144,200,344,8,0,0.5,0.5,10,5,279,284,0.825581395
511001,131,34,595,1122,1717,18,0,0.0,2.0,26,510,1106,1616,0.941176471
513001,110,13,234,390,624,10,0,0.0,0.0,14,209,399,608,0.974358974
513002,110,13,234,390,624,10,0,0.0,0.0,7,51,331,382,0.612179487
513003,110,13,234,390,624,10,0,0.0,0.0,9,385,157,542,0.868589744
513004,110,13,234,390,624,10,0,0.0,0.0,11,147,397,544,0.871794872
514001,107,15,330,435,765,14,0,0.0,0.0,15,132,539,671,0.877124183
514002,107,15,330,435,765,14,0,0.0,0.0,13,171,483,654,0.854901961
516001,65,13,780,390,1170,10,0,0.3,3.7,12,207,913,1120,0.957264957
516001,65,13,780,390,1170,10,0,0.3,4.7,12,442,698,1140,0.974358974
516002,65,13,780,390,1170,10,0,0.8,3.2,14,431,724,1155,0.987179487
516002,65,13,780,390,1170,10,0,0.8,4.2,12,303,792,1095,0.935897436
516003,65,13,780,390,1170,10,0,0.0,4.0,14,391,744,1135,0.97008547
516003,65,13,780,390,1170,10,0,0.0,5.0,12,625,535,1160,0.991452991
516004,65,13,780,390,1170,10,0,0.2,3.3,12,221,824,1045,0.893162393
516004,65,13,780,390,1170,10,0,0.2,4.3,11,124,896,1020,0.871794872
516005,65,13,780,390,1170,10,0,0.7,3.0,11,486,569,1055,0.901709402
516005,65,13,780,390,1170,10,0,0.7,4.0,9,410,500,910,0.777777778
517001,100,17,578,578,1156,35,0,0.0,5.428571,12,402,386,788,0.6816609
518001,96,10,155,235,390,10,0,0.4,1.6,9,211,147,358,0.917948718
518001,96,10,155,235,390,10,0,0.4,2.6,10,195,186,381,0.976923077
518002,96,10,155,235,390,10,0,0.4,1.6,7,-95,412,317,0.812820513
518002,96,10,155,235,390,10,0,0.4,2.6,10,66,264,330,0.846153846
518003,96,10,155,235,390,10,0,0.4,1.9,9,64,248,312,0.8
518003,96,10,155,235,390,10,0,0.4,2.9,11,111,222,333,0.853846154
518004,96,10,155,235,390,10,0,0.2,1.8,8,149,159,308,0.78974359
518004,96,10,155,235,390,10,0,0.2,2.8,10,222,148,370,0.948717949
520001,89,134,4336,4151,8487,75,0,0.0,2.0,148,4334,2513,6847,0.806763285
521001,107,9,225,303,528,7,0,0.0,0.0,9,254,274,528,1.0
522001,103,25,725,725,1450,10,0,0.0,0.0,25,794,656,1450,1.0
522001,103,25,725,725,1450,10,0,0.0,1.0,24,968,464,1432,0.987586207
522001,103,25,725,725,1450,10,0,0.0,2.0,24,998,426,1424,0.982068966
522002,103,20,600,600,1200,8,0,0.0,0.75,19,578,600,1178,0.981666667
522002,103,20,600,600,1200,8,0,0.0,1.75,20,731,469,1200,1.0
522002,103,20,600,600,1200,8,0,0.0,2.75,19,623,555,1178,0.981666667
523001,110,13,234,390,624,10,0,0.0,1.0,9,183,317,500,0.801282051
523002,110,13,234,390,624,10,0,0.0,0.0,8,177,251,428,0.685897436
523003,110,13,234,390,624,10,0,0.0,0.0,9,136,399,535,0.857371795
523004,110,13,234,390,624,10,0,0.0,0.0,12,269,292,561,0.899038462
523005,110,11,201,335,536,8,0,0.0,0.0,6,216,150,366,0.682835821
524001,78,13,312,156,468,10,0,1.2,8.8,7,59,305,364,0.777777778
524001,78,13,312,156,468,10,0,1.2,9.8,4,-137,361,224,0.478632479
524002,78,13,312,156,468,10,0,2.5,6.5,11,180,242,422,0.901709402
524002,78,13,312,156,468,10,0,2.5,7.5,9,115,215,330,0.705128205
527001,112,14,244,278,522,10,0,0.0,0.0,14,-180,661,481,0.921455939
527002,117,9,177,273,450,8,0,0.0,0.0,9,110,286,396,0.88
528001,100,18,407,407,814,36,0,0.0,0.0,18,502,312,814,1.0
529001,130,136,8325,8325,16650,52,0,0.0,3.1538463,150,6010,5391,11401,0.684744745
530001,85,8,140,140,280,10,0,0.0,0.0,10,-41,211,170,0.607142857
530002,85,8,140,140,280,10,0,0.0,0.0,10,139,111,250,0.892857143
530003,85,8,140,140,280,10,0,0.0,0.0,11,113,37,150,0.535714286
530004,85,8,140,140,280,10,0,0.0,0.0,10,78,112,190,0.678571429
530005,85,8,140,140,280,10,0,0.0,0.0,11,29,121,150,0.535714286
532001,110,21,420,630,1050,16,0,0.0625,1.9375,12,327,459,786,0.748571429
532001,110,21,420,630,1050,16,0,0.0625,2.9375,3,116,137,253,0.240952381
532002,110,21,420,630,1050,16,0,0.0,2.0,15,-41,918,877,0.835238095
532003,110,21,420,630,1050,16,0,0.0625,1.9375,15,100,786,886,0.843809524
532003,110,21,420,630,1050,16,0,0.0625,2.9375,1,28,58,86,0.081904762
532004,110,21,420,630,1050,16,0,0.0,2.0,14,320,530,850,0.80952381
532004,110,21,420,630,1050,16,0,0.0,3.0,1,53,44,97,0.092380952
532005,110,21,420,630,1050,16,0,0.0,2.0,17,289,680,969,0.922857143
532005,110,21,420,630,1050,16,0,0.0,3.0,1,20,51,71,0.067619048
532006,110,21,420,630,1050,16,0,0.0625,1.9375,17,161,751,912,0.868571429
532006,110,21,420,630,1050,16,0,0.0625,2.9375,1,39,57,96,0.091428571
532007,110,21,420,630,1050,16,0,0.0,2.0,15,173,774,947,0.901904762
532008,110,21,420,630,1050,16,0,0.0625,1.9375,19,-45,1039,994,0.946666667
532008,110,21,420,630,1050,16,0,0.0625,2.9375,1,-154,246,92,0.087619048
532009,110,21,420,630,1050,16,0,0.0625,2.0625,16,-195,1113,918,0.874285714
533001,120,6,105,195,300,12,0,0.0,0.0,6,232,68,300,1.0
533001,120,6,105,195,300,12,0,0.0,1.0,5,-25,295,270,0.9
533001,120,6,105,195,300,12,0,0.0,2.0,6,201,99,300,1.0
533001,120,6,105,195,300,12,0,0.0,3.0,3,-38,203,165,0.55
535001,83,16,151,286,437,30,0,0.0,0.0,23,174,46,220,0.503432494
536001,73,18,495,189,684,12,0,1.6666666,7.3333335,9,-107,597,490,0.716374269
536001,73,18,495,189,684,12,0,1.6666666,8.333333,9,39,459,498,0.728070175
537001,112,13,260,416,676,10,1,1.0,3.9,14,324,348,672,0.99408284
537002,112,13,260,416,676,10,1,1.0,3.6,12,161,505,666,0.985207101
539001,110,21,420,630,1050,15,0,0.53333336,0.8666667,19,345,646,991,0.943809524
539002,110,21,420,630,1050,15,0,0.6666667,0.8,21,195,825,1020,0.971428571
539003,110,21,420,630,1050,15,0,0.73333335,0.8,21,291,753,1044,0.994285714
541001,120,16,240,360,600,39,0,0.0,1.0,16,470,54,524,0.873333333
542001,65,13,780,390,1170,10,0,0.6,6.4,12,109,951,1060,0.905982906
542001,65,13,780,390,1170,10,0,0.6,7.4,13,421,719,1140,0.974358974
542002,65,13,780,390,1170,10,0,2.2,4.8,11,-145,1210,1065,0.91025641
542002,65,13,780,390,1170,10,0,2.2,5.8,8,317,333,650,0.555555556
542003,65,13,780,390,1170,10,0,0.8,6.0,11,285,755,1040,0.888888889
542003,65,13,780,390,1170,10,0,0.8,7.0,10,260,745,1005,0.858974359
542005,60,9,585,285,870,7,0,1.0,5.0,5,7,608,615,0.706896552
542005,60,9,585,285,870,7,0,1.0,6.0,6,201,474,675,0.775862069
543001,112,13,260,416,676,10,1,0.0,0.0,12,247,338,585,0.865384615
543001,112,13,260,416,676,10,1,0.0,1.0,12,89,521,610,0.902366864
543001,112,13,260,416,676,10,1,0.0,2.0,13,122,496,618,0.914201183
543001,112,13,260,416,676,10,1,0.0,3.0,10,54,515,569,0.841715976
543002,112,13,260,416,676,10,1,0.0,0.0,11,223,321,544,0.804733728
543002,112,13,260,416,676,10,1,0.0,1.0,9,20,481,501,0.74112426
543002,112,13,260,416,676,10,1,0.0,2.0,10,-57,586,529,0.782544379
543002,112,13,260,416,676,10,1,0.0,3.0,13,-16,686,670,0.99112426
543003,112,13,260,416,676,10,1,0.0,0.0,13,-504,1112,608,0.899408284
543003,112,13,260,416,676,10,1,0.0,1.0,15,-1,661,660,0.976331361
543003,112,13,260,416,676,10,1,0.0,2.0,8,-64,494,430,0.636094675
543003,112,13,260,416,676,10,1,0.0,3.0,12,-209,749,540,0.798816568
543004,112,13,260,416,676,10,1,0.0,0.0,12,174,467,641,0.948224852
543004,112,13,260,416,676,10,1,0.0,1.0,13,259,386,645,0.954142012
543004,112,13,260,416,676,10,1,0.0,2.0,10,441,139,580,0.857988166
543004,112,13,260,416,676,10,1,0.0,3.0,11,508,120,628,0.928994083
543005,112,13,260,416,676,10,1,0.0,0.0,10,-87,589,502,0.74260355
543005,112,13,260,416,676,10,1,0.0,1.0,12,383,233,616,0.911242604
543005,112,13,260,416,676,10,1,0.0,2.0,14,81,591,672,0.99408284
543005,112,13,260,416,676,10,1,0.0,3.0,15,320,340,660,0.976331361
543006,112,13,260,416,676,10,1,0.0,0.0,14,-39,689,650,0.961538462
543006,112,13,260,416,676,10,1,0.0,1.0,12,169,463,632,0.934911243
543006,112,13,260,416,676,10,1,0.0,2.0,13,209,435,644,0.952662722
543006,112,13,260,416,676,10,1,0.0,3.0,15,227,433,660,0.976331361
543007,112,13,260,416,676,10,1,0.0,0.0,9,-210,738,528,0.781065089
543007,112,13,260,416,676,10,1,0.0,1.0,12,-13,599,586,0.866863905
543007,112,13,260,416,676,10,1,0.0,2.0,12,101,559,660,0.976331361
543007,112,13,260,416,676,10,1,0.0,3.0,15,145,515,660,0.976331361
543008,112,13,260,416,676,10,1,0.0,0.0,12,318,324,642,0.949704142
543008,112,13,260,416,676,10,1,0.0,1.0,13,161,497,658,0.973372781
543008,112,13,260,416,676,10,1,0.0,2.0,12,254,347,601,0.889053254
543008,112,13,260,416,676,10,1,0.0,3.0,8,-62,476,414,0.612426036
543009,112,13,260,416,676,10,1,0.0,0.0,9,53,469,522,0.772189349
543009,112,13,260,416,676,10,1,0.0,1.0,14,146,518,664,0.982248521
543009,112,13,260,416,676,10,1,0.0,2.0,10,21,498,519,0.767751479
543009,112,13,260,416,676,10,1,0.0,3.0,10,168,382,550,0.813609467
543010,112,13,260,416,676,10,1,0.0,0.0,11,73,501,574,0.849112426
543010,112,13,260,416,676,10,1,0.0,1.0,13,165,439,604,0.893491124
543010,112,13,260,416,676,10,1,0.0,2.0,12,283,260,543,0.803254438
543010,112,13,260,416,676,10,1,0.0,3.0,12,180,360,540,0.798816568
543011,112,13,260,416,676,10,1,0.0,0.0,12,-205,825,620,0.917159763
543011,112,13,260,416,676,10,1,0.0,1.0,12,3,610,613,0.906804734
543011,112,13,260,416,676,10,1,0.0,2.0,8,-68,497,429,0.634615385
543011,112,13,260,416,676,10,1,0.0,3.0,11,140,389,529,0.782544379
543012,112,13,260,416,676,10,1,0.0,0.0,11,358,250,608,0.899408284
543012,112,13,260,416,676,10,1,0.0,1.0,12,272,280,552,0.816568047
543012,112,13,260,416,676,10,1,0.0,2.0,12,-19,571,552,0.816568047
543012,112,13,260,416,676,10,1,0.0,3.0,10,74,413,487,0.720414201
543013,112,13,260,416,676,10,1,0.0,0.0,14,544,114,658,0.973372781
543013,112,13,260,416,676,10,1,0.0,1.0,9,376,150,526,0.778106509
543013,112,13,260,416,676,10,1,0.0,2.0,11,353,237,590,0.872781065
543013,112,13,260,416,676,10,1,0.0,3.0,8,237,216,453,0.670118343
543014,112,13,260,416,676,10,1,0.0,0.0,12,308,268,576,0.852071006
543014,112,13,260,416,676,10,1,0.0,1.0,13,-66,681,615,0.909763314
543014,112,13,260,416,676,10,1,0.0,2.0,11,149,440,589,0.871301775
543014,112,13,260,416,676,10,1,0.0,3.0,11,186,412,598,0.884615385
543015,112,13,260,416,676,10,1,0.0,0.0,14,156,516,672,0.99408284
543015,112,13,260,416,676,10,1,0.0,1.0,12,281,343,624,0.923076923
543015,112,13,260,416,676,10,1,0.0,2.0,11,239,296,535,0.791420118
543015,112,13,260,416,676,10,1,0.0,3.0,11,277,271,548,0.810650888
543016,112,13,260,416,676,10,1,0.0,0.0,11,14,496,510,0.75443787
543016,112,13,260,416,676,10,1,0.0,1.0,9,561,-52,509,0.75295858
543016,112,13,260,416,676,10,1,0.0,2.0,7,338,111,449,0.664201183
543016,112,13,260,416,676,10,1,0.0,3.0,11,432,129,561,0.829881657
543017,112,13,260,416,676,10,1,0.0,0.0,13,-151,758,607,0.897928994
543017,112,13,260,416,676,10,1,0.0,1.0,13,124,522,646,0.955621302
543017,112,13,260,416,676,10,1,0.0,2.0,10,86,468,554,0.819526627
543017,112,13,260,416,676,10,1,0.0,3.0,12,-37,598,561,0.829881657
543018,112,13,260,416,676,10,1,0.0,0.0,12,189,415,604,0.893491124
543018,112,13,260,416,676,10,1,0.0,1.0,14,347,298,645,0.954142012
543018,112,13,260,416,676,10,1,0.0,2.0,10,342,262,604,0.893491124
543018,112,13,260,416,676,10,1,0.0,3.0,9,155,338,493,0.729289941
543019,112,13,260,416,676,10,1,0.0,0.0,13,-303,946,643,0.951183432
543019,112,13,260,416,676,10,1,0.0,1.0,9,321,209,530,0.784023669
543019,112,13,260,416,676,10,1,0.0,2.0,8,412,21,433,0.640532544
543019,112,13,260,416,676,10,1,0.0,3.0,6,197,141,338,0.5
543020,112,13,260,416,676,10,1,0.0,0.0,12,540,78,618,0.914201183
543020,112,13,260,416,676,10,1,0.0,1.0,10,519,94,613,0.906804734
543020,112,13,260,416,676,10,1,0.0,2.0,12,576,53,629,0.930473373
543020,112,13,260,416,676,10,1,0.0,3.0,14,489,175,664,0.982248521
543021,112,13,260,416,676,10,1,0.0,0.0,12,109,532,641,0.948224852
543021,112,13,260,416,676,10,1,0.0,1.0,9,283,260,543,0.803254438
543021,112,13,260,416,676,10,1,0.0,2.0,11,319,285,604,0.893491124
543021,112,13,260,416,676,10,1,0.0,3.0,12,399,191,590,0.872781065
543022,112,13,260,416,676,10,1,0.0,0.0,12,-497,1110,613,0.906804734
543022,112,13,260,416,676,10,1,0.0,1.0,13,-362,1014,652,0.964497041
543022,112,13,260,416,676,10,1,0.0,2.0,13,-2,665,663,0.980769231
543022,112,13,260,416,676,10,1,0.0,3.0,11,54,559,613,0.906804734
543023,112,13,260,416,676,10,1,0.0,0.0,12,104,508,612,0.905325444
543023,112,13,260,416,676,10,1,0.0,1.0,15,347,313,660,0.976331361
543023,112,13,260,416,676,10,1,0.0,2.0,13,280,326,606,0.896449704
543023,112,13,260,416,676,10,1,0.0,3.0,9,306,230,536,0.792899408
543024,112,13,260,416,676,10,1,0.0,0.0,13,222,422,644,0.952662722
543024,112,13,260,416,676,10,1,0.0,1.0,13,301,370,671,0.99260355
543024,112,13,260,416,676,10,1,0.0,2.0,13,157,488,645,0.954142012
543024,112,13,260,416,676,10,1,0.0,3.0,11,-222,751,529,0.782544379
543028,110,3,75,105,180,2,0,0.0,0.0,1,150,-50,100,0.555555556
543028,97,3,114,111,225,3,0,0.0,0.6666667,1,20,80,100,0.444444444
544001,112,13,260,416,676,10,1,0.0,3.0,12,385,244,629,0.930473373
545001,112,13,260,416,676,10,1,0.0,3.0,12,254,313,567,0.838757396
545002,112,13,260,416,676,10,1,0.0,2.9,12,310,315,625,0.924556213
545003,112,13,260,416,676,10,1,0.0,2.8,13,227,416,643,0.951183432
545004,112,13,260,416,676,10,1,0.0,2.5,13,514,148,662,0.979289941
545005,112,13,260,416,676,10,1,0.0,2.9,13,424,219,643,0.951183432
545006,112,13,260,416,676,10,1,0.0,3.0,15,285,375,660,0.976331361
546001,114,30,645,1050,1695,20,0,0.0,0.0,25,1595,-131,1464,0.863716814
548001,78,13,312,156,468,10,0,0.6,9.7,9,-2,356,354,0.756410256
548001,78,13,312,156,468,10,0,0.6,10.7,9,266,122,388,0.829059829
548002,78,13,312,156,468,10,0,0.8,8.7,11,26,420,446,0.952991453
548002,78,13,312,156,468,10,0,0.8,9.7,9,107,261,368,0.786324786
548003,78,13,312,156,468,10,0,1.0,9.2,10,83,267,350,0.747863248
548003,78,13,312,156,468,10,0,1.0,10.2,10,138,250,388,0.829059829
548004,78,13,312,156,468,10,0,1.2,10.0,9,58,280,338,0.722222222
548004,78,13,312,156,468,10,0,1.2,11.0,10,-50,406,356,0.760683761
550001,115,33,1089,1089,2178,14,0,0.0,1.1428572,32,905,1249,2154,0.988980716
558001,118,9,144,216,360,8,0,0.0,0.0,7,232,86,318,0.883333333
558002,118,9,144,216,360,8,0,0.0,0.0,7,-216,496,280,0.777777778
558003,118,9,144,216,360,8,0,0.0,0.0,4,27,141,168,0.466666667
560001,116,17,306,578,884,12,0,0.0,0.5,10,60,574,634,0.71719457
560002,116,17,306,578,884,12,0,0.0,0.0,13,327,457,784,0.886877828
560003,116,17,306,578,884,12,0,0.0,0.5,10,177,363,540,0.610859729
562001,110,11,220,330,550,12,0,0.0,0.0,12,255,285,540,0.981818182
562002,110,11,220,330,550,12,0,0.0,0.0,12,-302,842,540,0.981818182
562003,110,11,220,330,550,12,0,0.0,0.0,12,-80,620,540,0.981818182
562004,110,11,220,330,550,12,0,0.0,0.0,12,149,391,540,0.981818182
565001,112,13,260,416,676,10,1,0.0,0.0,11,490,123,613,0.906804734
565002,112,13,260,416,676,10,1,0.0,0.0,14,93,569,662,0.979289941
565003,112,13,260,416,676,10,1,0.0,0.0,14,460,200,660,0.976331361
565004,112,13,260,416,676,10,1,0.0,0.0,12,76,544,620,0.917159763
565005,112,13,260,416,676,10,1,0.0,0.1,12,480,107,587,0.868343195
566001,90,10,275,275,550,20,0,0.0,0.8,7,278,172,450,0.818181818
566001,90,10,275,275,550,21,0,0.0,1.7142857,10,270,255,525,0.954545455
566001,90,10,275,275,550,21,0,0.0,2.7142856,9,272,248,520,0.945454545
566001,90,10,275,275,550,21,0,0.0,3.7142856,10,326,224,550,1.0
566001,90,10,275,275,550,21,0,0.0,4.714286,8,265,190,455,0.827272727
567001,108,252,5418,7652,13070,60,0,0.0,0.0,167,7477,2153,9630,0.736801836
567002,108,252,5418,7652,13070,60,0,0.0,0.13333334,197,7547,3126,10673,0.816602907
567003,108,252,5418,7652,13070,60,0,0.0,0.06666667,172,4595,5260,9855,0.754016832
567004,108,252,5418,7652,13070,60,0,0.0,0.0,192,8937,1561,10498,0.803213466
567005,108,252,5418,7652,13070,60,0,0.0,0.0,150,8621,788,9409,0.719892884
567006,110,122,2443,3960,6403,30,0,0.0,0.26666668,63,1811,2127,3938,0.615024207
569001,96,10,155,235,390,10,0,0.1,2.5,13,-77,405,328,0.841025641
569001,96,10,155,235,390,10,0,0.1,3.5,13,5,335,340,0.871794872
569002,96,10,155,235,390,10,0,0.1,1.9,7,86,221,307,0.787179487
569002,96,10,155,235,390,10,0,0.1,2.9,9,123,258,381,0.976923077
569003,96,10,155,235,390,10,0,0.3,1.7,11,92,281,373,0.956410256
569003,96,10,155,235,390,10,0,0.3,2.7,9,137,184,321,0.823076923
569004,96,10,155,235,390,10,0,0.4,1.6,11,42,314,356,0.912820513
569004,96,10,155,235,390,10,0,0.4,2.6,10,199,168,367,0.941025641
570001,110,21,420,630,1050,16,0,1.125,1.375,21,330,668,998,0.95047619
571001,112,13,260,416,676,10,1,0.0,0.0,12,353,296,649,0.960059172
571002,112,13,260,416,676,10,1,0.0,0.0,12,218,404,622,0.920118343
571003,112,13,260,416,676,10,1,0.0,0.0,13,367,273,640,0.946745562
571004,112,13,260,416,676,10,1,0.0,0.0,11,125,407,532,0.786982249
572001,96,24,300,552,852,10,0,0.0,0.0,14,208,430,638,0.748826291
572001,96,24,300,552,852,10,0,0.0,1.0,12,507,87,594,0.697183099
572001,96,24,300,552,852,10,0,0.0,2.0,13,146,390,536,0.629107981
572002,96,24,300,552,852,10,0,0.0,0.6,13,193,433,626,0.734741784
572002,96,24,300,552,852,10,0,0.0,1.6,20,40,728,768,0.901408451
572002,96,24,300,552,852,10,0,0.0,2.6,19,239,447,686,0.805164319
572003,96,24,300,552,852,10,0,0.0,1.2,16,623,30,653,0.766431925
572003,96,24,300,552,852,10,0,0.0,2.2,14,202,406,608,0.713615023
572003,96,24,300,552,852,10,0,0.0,3.2,17,536,219,755,0.886150235
572004,85,5,125,131,256,3,0,0.0,0.0,1,33,37,70,0.2734375
572004,95,10,145,240,385,4,0,0.0,0.75,7,105,239,344,0.893506494
572004,95,10,145,240,385,4,0,0.0,1.75,5,90,176,266,0.690909091
575001,105,6,150,180,330,15,0,0.0,0.2,3,64,130,194,0.587878788
575001,105,6,150,180,330,15,0,0.0,1.2,6,137,193,330,1.0
575002,105,6,150,180,330,15,0,0.33333334,0.4,4,-45,307,262,0.793939394
575002,105,6,150,180,330,15,0,0.33333334,1.4,6,232,64,296,0.896969697
577001,112,13,260,416,676,10,1,2.0,2.0,11,236,386,622,0.920118343
577001,112,13,260,416,676,10,1,2.0,3.0,11,301,350,651,0.963017751
577002,112,13,260,416,676,10,1,2.0,2.0,12,182,471,653,0.965976331
577002,112,13,260,416,676,10,1,2.0,3.0,14,334,335,669,0.98964497
577003,112,13,260,416,676,10,1,2.0,2.0,13,124,510,634,0.937869822
577003,112,13,260,416,676,10,1,2.0,3.0,12,247,393,640,0.946745562
578001,85,8,140,140,280,10,0,0.0,0.0,7,129,46,175,0.625
578002,85,8,140,140,280,10,0,0.0,0.0,9,145,75,220,0.785714286
578003,85,8,140,140,280,10,0,0.0,0.0,9,-140,360,220,0.785714286
578004,85,8,140,140,280,10,0,0.0,0.0,10,-65,275,210,0.75
578005,85,8,140,140,280,10,0,0.0,0.0,11,189,16,205,0.732142857
578006,85,8,140,140,280,10,0,0.0,0.0,9,32,213,245,0.875
578007,85,8,140,140,280,10,0,0.0,0.0,7,82,158,240,0.857142857
578008,85,8,140,140,280,10,0,0.0,0.0,13,-448,563,115,0.410714286
578009,85,8,140,140,280,10,0,0.0,0.0,8,33,202,235,0.839285714
580001,112,13,260,416,676,10,1,0.0,4.0,13,442,217,659,0.974852071
580002,112,13,260,416,676,10,1,0.0,4.0,10,288,299,587,0.868343195
580003,112,13,260,416,676,10,1,0.0,3.6,12,384,223,607,0.897928994
580004,112,13,260,416,676,10,1,0.0,4.0,12,328,326,654,0.967455621
581012,100,50,1275,1275,2550,20,0,0.15,2.4,36,882,1223,2105,0.825490196
582001,107,113,2461,3360,5821,26,0,4.3076925,1.6923077,80,2915,1862,4777,0.820649373
582001,107,113,2461,3360,5821,26,0,4.3076925,2.6923077,74,2783,1670,4453,0.764988834
582001,107,113,2461,3360,5821,26,0,4.3076925,3.6923077,93,3636,1350,4986,0.856553857
582001,107,113,2461,3360,5821,26,0,4.3076925,4.6923075,88,3190,1658,4848,0.83284659
583001,112,13,260,416,676,10,1,0.0,0.0,12,-88,607,519,0.767751479
583002,112,13,260,416,676,10,1,0.0,0.0,12,-290,886,596,0.881656805
583003,112,13,260,416,676,10,1,0.1,0.9,11,396,240,636,0.940828402
583004,112,13,260,416,676,10,1,0.0,0.0,12,609,-11,598,0.884615385
584001,102,49,1227,1278,2505,34,0,0.0,2.9117646,42,1374,926,2300,0.918163673
585001,95,10,135,225,360,10,0,0.0,0.0,9,-28,356,328,0.911111111
585001,95,10,135,225,360,10,0,0.0,1.0,12,151,161,312,0.866666667
585002,95,10,135,225,360,10,0,0.0,0.0,13,58,225,283,0.786111111
585002,95,10,135,225,360,10,0,0.0,1.0,13,387,-99,288,0.8
586001,112,13,260,416,676,10,1,0.5,0.5,7,1,495,496,0.733727811
586002,112,13,260,416,676,10,1,0.2,0.8,9,221,275,496,0.733727811
587001,90,41,820,820,1640,30,0,0.0,0.13333334,35,894,595,1489,0.907926829
587001,90,41,820,820,1640,30,0,0.0,1.1333333,36,948,573,1521,0.927439024
587001,90,41,820,820,1640,30,0,0.0,2.1333334,37,577,966,1543,0.940853659
587001,90,41,820,820,1640,30,0,0.0,3.1333334,43,207,1394,1601,0.976219512
587002,90,41,820,820,1640,30,0,0.0,0.0,33,104,1355,1459,0.889634146
587002,90,41,820,820,1640,30,0,0.0,1.0,38,498,972,1470,0.896341463
587002,90,41,820,820,1640,30,0,0.0,2.0,34,335,1122,1457,0.888414634
587002,90,41,820,820,1640,30,0,0.0,3.0,37,655,826,1481,0.90304878
587003,90,41,820,820,1640,30,0,0.0,0.0,37,365,1218,1583,0.965243902
587003,90,41,820,820,1640,30,0,0.0,1.0,43,567,1050,1617,0.98597561
587003,90,41,820,820,1640,30,0,0.0,2.0,38,350,1206,1556,0.948780488
587003,90,41,820,820,1640,30,0,0.0,3.0,37,575,1027,1602,0.976829268
587004,90,41,820,820,1640,30,0,0.0,0.0,36,1146,404,1550,0.945121951
587004,90,41,820,820,1640,30,0,0.0,1.0,37,499,969,1468,0.895121951
587004,90,41,820,820,1640,30,0,0.0,2.0,34,937,526,1463,0.892073171
587004,90,41,820,820,1640,30,0,0.0,3.0,35,410,1058,1468,0.895121951
587005,90,41,820,820,1640,30,0,0.0,0.0,35,384,1025,1409,0.859146341
587005,90,41,820,820,1640,30,0,0.0,1.0,40,487,1056,1543,0.940853659
587005,90,41,820,820,1640,30,0,0.0,2.0,38,795,718,1513,0.922560976
587005,90,41,820,820,1640,30,0,0.0,3.0,37,391,1115,1506,0.918292683
587006,90,41,820,820,1640,30,0,0.0,0.0,36,513,953,1466,0.893902439
587006,90,41,820,820,1640,30,0,0.0,1.0,36,780,702,1482,0.903658537
587006,90,41,820,820,1640,30,0,0.0,2.0,38,551,941,1492,0.909756098
587006,90,41,820,820,1640,30,0,0.0,3.0,43,841,770,1611,0.982317073
587007,90,41,820,820,1640,30,0,0.0,0.13333334,29,129,1165,1294,0.78902439
587007,90,41,820,820,1640,30,0,0.0,1.1333333,36,655,840,1495,0.911585366
587007,90,41,820,820,1640,30,0,0.0,2.1333334,30,328,1084,1412,0.86097561
587007,90,41,820,820,1640,30,0,0.0,3.1333334,35,607,859,1466,0.893902439
587008,90,41,820,820,1640,30,0,0.0,0.0,37,851,651,1502,0.915853659
587008,90,41,820,820,1640,30,0,0.0,1.0,40,627,956,1583,0.965243902
587008,90,41,820,820,1640,30,0,0.0,2.0,37,834,670,1504,0.917073171
587008,90,41,820,820,1640,30,0,0.0,3.0,39,526,1055,1581,0.96402439
587009,90,41,820,820,1640,30,0,0.0,0.13333334,31,355,973,1328,0.809756098
587009,90,41,820,820,1640,30,0,0.0,1.1333333,38,478,1037,1515,0.923780488
587009,90,41,820,820,1640,30,0,0.0,2.1333334,40,811,785,1596,0.973170732
587009,90,41,820,820,1640,30,0,0.0,3.1333334,36,296,1217,1513,0.922560976
587010,90,41,820,820,1640,30,0,0.0,0.0,25,209,902,1111,0.677439024
587010,90,41,820,820,1640,30,0,0.0,1.0,34,-327,1754,1427,0.870121951
587010,90,41,820,820,1640,30,0,0.0,2.0,34,801,584,1385,0.844512195
587010,90,41,820,820,1640,30,0,0.0,3.0,37,211,1281,1492,0.909756098
588001,112,13,260,416,676,10,1,0.0,1.6,9,0,502,502,0.74260355
588002,112,13,260,416,676,10,1,0.0,2.0,10,-225,782,557,0.823964497
588003,112,13,260,416,676,10,1,0.0,1.7,10,421,123,544,0.804733728
588004,112,13,260,416,676,10,1,0.0,2.0,6,117,246,363,0.536982249
588005,112,13,260,416,676,10,1,0.0,2.0,8,49,423,472,0.698224852
589001,500,18,4716,4716,9432,24,0,0.0,5.0416665,20,-871,8075,7204,0.763782867
590001,112,13,260,416,676,10,1,0.3,0.6,9,220,319,539,0.797337278
590002,112,13,260,416,676,10,1,0.2,0.8,10,110,500,610,0.902366864
590003,112,13,260,416,676,10,1,0.1,0.9,9,312,264,576,0.852071006
590004,101,6,195,201,396,5,0,0.0,0.8,5,-89,413,324,0.818181818
591001,114,4,114,150,264,8,0,0.0,0.0,3,130,70,200,0.757575758
591001,114,4,114,150,264,8,0,0.0,1.0,3,42,154,196,0.742424242
591001,114,4,114,150,264,8,0,0.0,2.0,3,104,102,206,0.78030303
591001,114,4,114,150,264,8,0,0.0,3.0,3,48,163,211,0.799242424
592001,112,13,260,416,676,10,1,2.0,4.0,14,152,494,646,0.955621302
592002,112,13,260,416,676,10,1,2.2,3.8,13,318,327,645,0.954142012
592003,112,13,260,416,676,10,1,2.6,3.4,11,368,178,546,0.807692308
592004,107,9,225,303,528,7,0,2.857143,3.142857,9,161,352,513,0.971590909
594001,96,10,155,235,390,10,0,0.0,0.5,10,124,248,372,0.953846154
594001,96,10,155,235,390,10,0,0.0,1.5,9,112,183,295,0.756410256
596001,112,13,260,416,676,10,1,0.0,0.0,15,152,508,660,0.976331361
596002,112,13,260,416,676,10,1,0.0,0.0,14,66,574,640,0.946745562
596003,112,13,260,416,676,10,1,0.0,0.0,12,-35,596,561,0.829881657
596004,112,13,260,416,676,10,1,0.0,0.0,14,21,634,655,0.968934911
596005,112,13,260,416,676,10,1,0.0,0.0,14,387,274,661,0.977810651
596006,112,13,260,416,676,10,1,0.0,0.0,14,76,586,662,0.979289941
596007,112,13,260,416,676,10,1,0.0,0.0,12,272,344,616,0.911242604
596008,112,13,260,416,676,10,1,0.0,0.0,12,-17,619,602,0.890532544
596009,112,13,260,416,676,10,1,0.0,0.0,12,-39,666,627,0.927514793
596010,112,13,260,416,676,10,1,0.0,0.0,15,327,333,660,0.976331361
596011,112,13,260,416,676,10,1,0.0,0.0,12,370,233,603,0.892011834
596012,112,11,223,357,580,8,0,0.0,0.0,10,-2,516,514,0.886206897
597001,112,13,260,416,676,10,1,0.0,0.9,12,386,262,648,0.958579882
597002,112,13,260,416,676,10,1,0.0,1.0,13,302,341,643,0.951183432
597003,112,13,260,416,676,10,1,0.0,1.0,12,229,335,564,0.834319527
597004,112,13,260,416,676,10,1,0.0,1.0,15,-103,763,660,0.976331361
597005,112,13,260,416,676,10,1,0.0,0.9,14,243,418,661,0.977810651
597006,112,13,260,416,676,10,1,0.0,1.0,14,-18,673,655,0.968934911
597007,112,13,260,416,676,10,1,0.0,1.0,15,48,612,660,0.976331361
597008,112,13,260,416,676,10,1,0.0,0.9,13,153,493,646,0.955621302
597009,112,13,260,416,676,10,1,0.0,1.0,15,-55,715,660,0.976331361
597010,112,13,260,416,676,10,1,0.0,1.0,14,10,641,651,0.963017751
598001,112,13,260,416,676,10,1,0.0,0.5,13,420,239,659,0.974852071
598002,112,13,260,416,676,10,1,0.0,0.1,12,410,206,616,0.911242604
598005,110,3,75,105,180,2,0,0.0,0.0,2,65,95,160,0.888888889
600001,125,5,65,115,180,19,0,0.0,0.21052632,6,62,47,109,0.605555556
600001,125,5,65,115,180,19,0,0.0,1.2105263,6,-229,319,90,0.5
600001,125,5,65,115,180,19,0,0.0,2.2105262,4,35,21,56,0.311111111
601001,112,13,260,416,676,10,1,0.0,0.0,10,490,46,536,0.792899408
603001,105,12,276,330,606,9,0,0.0,0.0,11,316,237,553,0.912541254
603002,105,12,276,330,606,9,0,0.0,0.0,10,448,113,561,0.925742574
608001,65,13,780,390,1170,10,0,0.5,4.5,11,219,911,1130,0.965811966
608001,65,13,780,390,1170,10,0,0.5,5.5,12,530,595,1125,0.961538462
608002,65,13,780,390,1170,10,0,0.4,4.1,11,444,596,1040,0.888888889
608002,65,13,780,390,1170,10,0,0.4,5.1,13,494,656,1150,0.982905983
608003,65,13,780,390,1170,10,0,0.4,4.1,10,317,688,1005,0.858974359
608003,65,13,780,390,1170,10,0,0.4,5.1,12,278,852,1130,0.965811966
608004,67,6,378,207,585,4,0,0.5,4.5,5,132,438,570,0.974358974
609001,112,13,260,416,676,10,1,0.0,0.0,14,505,161,666,0.985207101
609001,112,13,260,416,676,10,1,0.0,1.0,14,-222,891,669,0.98964497
609001,112,13,260,416,676,10,1,0.0,2.0,13,600,49,649,0.960059172
609001,112,13,260,416,676,10,1,0.0,3.0,13,-22,654,632,0.934911243
609001,112,13,260,416,676,10,1,0.0,4.0,13,528,120,648,0.958579882
609002,112,13,260,416,676,10,1,0.0,0.0,14,-422,1071,649,0.960059172
609002,112,13,260,416,676,10,1,0.0,1.0,14,397,260,657,0.971893491
609002,112,13,260,416,676,10,1,0.0,2.0,15,195,465,660,0.976331361
609002,112,13,260,416,676,10,1,0.0,3.0,13,345,317,662,0.979289941
609002,112,13,260,416,676,10,1,0.0,4.0,12,293,379,672,0.99408284
609003,112,13,260,416,676,10,1,0.0,0.0,13,-346,944,598,0.884615385
609003,112,13,260,416,676,10,1,0.0,1.0,11,-146,751,605,0.894970414
609003,112,13,260,416,676,10,1,0.0,2.0,14,420,237,657,0.971893491
609003,112,13,260,416,676,10,1,0.0,3.0,11,70,550,620,0.917159763
609003,112,13,260,416,676,10,1,0.0,4.0,14,278,371,649,0.960059172
609004,112,13,260,416,676,10,1,0.0,0.0,12,118,524,642,0.949704142
609004,112,13,260,416,676,10,1,0.0,1.0,13,280,396,676,1.0
609004,112,13,260,416,676,10,1,0.0,2.0,15,241,419,660,0.976331361
609004,112,13,260,416,676,10,1,0.0,3.0,14,310,343,653,0.965976331
609004,112,13,260,416,676,10,1,0.0,4.0,14,355,298,653,0.965976331
611001,95,10,135,225,360,10,0,0.2,0.8,11,154,154,308,0.855555556
611001,95,10,135,225,360,10,0,0.2,1.8,9,183,122,305,0.847222222
611002,95,10,135,225,360,10,0,0.1,0.9,9,206,142,348,0.966666667
611002,95,10,135,225,360,10,0,0.1,1.9,8,200,117,317,0.880555556
611003,95,10,135,225,360,10,0,0.0,1.0,9,-12,287,275,0.763888889
611003,95,10,135,225,360,10,0,0.0,2.0,8,15,265,280,0.777777778
611004,95,10,135,225,360,10,0,0.0,1.0,10,12,325,337,0.936111111
611004,95,10,135,225,360,10,0,0.0,2.0,9,56,278,334,0.927777778
611005,95,10,135,225,360,10,0,0.1,0.9,12,184,117,301,0.836111111
611005,95,10,135,225,360,10,0,0.1,1.9,10,122,126,248,0.688888889
612001,112,13,260,416,676,10,1,0.0,2.0,5,-373,658,285,0.421597633
612002,112,13,260,416,676,10,1,0.0,2.3,8,352,3,355,0.525147929
612003,112,13,260,416,676,10,1,0.0,2.2,8,264,204,468,0.692307692
612004,112,13,260,416,676,10,1,0.0,3.4,3,72,139,211,0.312130178
612005,112,13,260,416,676,10,1,0.0,1.6,5,93,240,333,0.49260355
612006,107,9,225,303,528,7,0,0.0,1.4285715,6,185,181,366,0.693181818
613001,112,13,260,416,676,10,1,0.2,0.8,10,271,309,580,0.857988166
613001,112,13,260,416,676,10,1,0.2,1.8,10,266,338,604,0.893491124
613002,112,13,260,416,676,10,1,0.2,0.8,10,261,324,585,0.865384615
613002,112,13,260,416,676,10,1,0.2,1.8,9,186,303,489,0.723372781
615001,65,13,780,390,1170,10,0,0.1,3.9,10,94,946,1040,0.888888889
615001,65,13,780,390,1170,10,0,0.1,4.9,8,278,627,905,0.773504274
615002,65,13,780,390,1170,10,0,0.4,3.2,8,-85,935,850,0.726495726
615002,65,13,780,390,1170,10,0,0.4,4.2,9,388,677,1065,0.91025641
615003,65,13,780,390,1170,10,0,0.5,3.2,7,284,576,860,0.735042735
615003,65,13,780,390,1170,10,0,0.5,4.2,7,309,566,875,0.747863248
615004,65,13,780,390,1170,10,0,0.3,3.3,12,391,749,1140,0.974358974
615004,65,13,780,390,1170,10,0,0.3,4.3,9,492,368,860,0.735042735
616002,91,35,1505,1080,2585,15,0,0.0,0.0,17,1445,-61,1384,0.535396518
617001,65,13,780,390,1170,10,0,0.2,5.8,12,164,866,1030,0.88034188
617001,65,13,780,390,1170,10,0,0.2,6.8,11,253,842,1095,0.935897436
617002,65,13,780,390,1170,10,0,0.5,6.2,8,252,748,1000,0.854700855
617002,65,13,780,390,1170,10,0,0.5,7.2,9,298,762,1060,0.905982906
617003,65,13,780,390,1170,10,0,0.8,5.1,8,170,720,890,0.760683761
617003,65,13,780,390,1170,10,0,0.8,6.1,7,201,674,875,0.747863248
617004,65,13,780,390,1170,10,0,0.5,4.7,9,263,727,990,0.846153846
617004,65,13,780,390,1170,10,0,0.5,5.7,10,295,800,1095,0.935897436
617005,65,13,780,390,1170,10,0,0.2,5.4,6,225,550,775,0.662393162
617005,65,13,780,390,1170,10,0,0.2,6.4,8,262,718,980,0.837606838
621001,112,13,260,416,676,10,1,0.0,0.3,14,64,595,659,0.974852071
621002,112,13,260,416,676,10,1,0.0,0.0,12,-24,646,622,0.920118343
621003,112,13,260,416,676,10,1,0.0,0.0,13,-25,682,657,0.971893491
621004,112,13,260,416,676,10,1,0.0,0.0,13,652,8,660,0.976331361
621005,112,13,260,416,676,10,1,0.0,0.0,11,2,619,621,0.918639053
621006,112,13,260,416,676,10,1,0.0,0.0,11,-344,910,566,0.837278107
621007,112,13,260,416,676,10,1,0.0,0.6,10,-32,591,559,0.826923077
621008,112,13,260,416,676,10,1,0.0,0.3,12,265,359,624,0.923076923
621009,112,13,260,416,676,10,1,0.0,0.3,8,-47,521,474,0.701183432
621010,112,13,260,416,676,10,1,0.0,0.0,6,-345,770,425,0.628698225
621011,112,11,223,357,580,8,0,0.0,0.0,6,465,-69,396,0.682758621
626001,112,13,260,416,676,10,1,0.0,0.0,10,243,263,506,0.74852071
626002,112,13,260,416,676,10,1,0.0,0.0,14,198,471,669,0.98964497
626003,112,13,260,416,676,10,1,0.0,0.0,13,280,358,638,0.943786982
628001,112,13,260,416,676,10,1,0.0,1.0,7,253,203,456,0.674556213
628001,112,13,260,416,676,10,1,0.0,2.0,8,236,239,475,0.702662722
630001,112,13,260,416,676,10,1,0.0,2.3,10,588,-58,530,0.784023669
630002,112,13,260,416,676,10,1,0.4,2.9,9,16,425,441,0.652366864
630003,112,13,260,416,676,10,1,0.0,3.6,12,30,522,552,0.816568047
632001,100,51,1275,1275,2550,66,0,0.0,0.0,48,856,1312,2168,0.850196078
632001,100,51,1275,1275,2550,66,0,0.0,1.0,48,1173,1197,2370,0.929411765
632001,100,51,1275,1275,2550,66,0,0.0,2.0,49,696,1733,2429,0.95254902
632001,100,51,1275,1275,2550,66,0,0.0,3.0,49,591,1764,2355,0.923529412
632001,100,51,1275,1275,2550,66,0,0.0,6.8636365,51,1033,1391,2424,0.950588235
632001,100,51,1275,1275,2550,66,0,0.0,7.8636365,47,1364,1007,2371,0.929803922
632001,100,51,1275,1275,2550,66,0,0.0,8.863636,50,864,1534,2398,0.940392157
632001,100,51,1275,1275,2550,66,0,0.0,9.863636,52,1313,1164,2477,0.971372549
633001,65,13,780,390,1170,10,0,0.3,5.2,9,705,275,980,0.837606838
633001,65,13,780,390,1170,10,0,0.3,6.2,10,778,227,1005,0.858974359
633002,65,13,780,390,1170,10,0,0.4,5.5,13,390,780,1170,1.0
633002,65,13,780,390,1170,10,0,0.4,6.5,9,347,503,850,0.726495726
633003,65,13,780,390,1170,10,0,0.6,4.8,12,605,535,1140,0.974358974
633003,65,13,780,390,1170,10,0,0.6,5.8,13,434,696,1130,0.965811966
633004,65,13,780,390,1170,10,0,0.6,5.2,9,199,746,945,0.807692308
633004,65,13,780,390,1170,10,0,0.6,6.2,10,512,423,935,0.799145299
633006,57,6,438,207,645,5,0,0.2,3.0,3,213,182,395,0.612403101
633006,57,6,438,207,645,5,0,0.2,4.0,2,67,213,280,0.434108527
634001,117,10,159,385,544,10,0,0.0,5.7,10,131,296,427,0.784926471
634002,110,12,228,330,558,10,0,0.0,5.4,10,257,202,459,0.822580645
634003,99,6,129,149,278,5,0,0.0,4.8,3,139,-15,124,0.446043165
636001,78,13,312,156,468,10,0,0.2,1.8,8,127,191,318,0.679487179
636001,78,13,312,156,468,10,0,0.2,2.8,7,175,141,316,0.675213675
636001,78,13,312,156,468,10,0,0.2,3.8,8,112,246,358,0.764957265
636001,78,13,312,156,468,10,0,0.2,4.8,7,159,171,330,0.705128205
636001,78,13,312,156,468,10,0,0.2,5.8,6,111,189,300,0.641025641
636002,78,13,312,156,468,10,0,0.2,2.2,3,-56,236,180,0.384615385
636002,78,13,312,156,468,10,0,0.2,3.2,5,44,216,260,0.555555556
636002,78,13,312,156,468,10,0,0.2,4.2,6,63,243,306,0.653846154
636002,78,13,312,156,468,10,0,0.2,5.2,4,39,177,216,0.461538462
636002,78,13,312,156,468,10,0,0.2,6.2,4,-57,245,188,0.401709402
636003,78,13,312,156,468,10,0,0.0,1.8,10,91,317,408,0.871794872
636003,78,13,312,156,468,10,0,0.0,2.8,7,111,235,346,0.739316239
636003,78,13,312,156,468,10,0,0.0,3.8,7,102,260,362,0.773504274
636003,78,13,312,156,468,10,0,0.0,4.8,6,85,221,306,0.653846154
636003,78,13,312,156,468,10,0,0.0,5.8,6,-13,255,242,0.517094017
636004,78,13,312,156,468,10,0,0.2,1.8,7,-48,344,296,0.632478632
636004,78,13,312,156,468,10,0,0.2,2.8,8,64,332,396,0.846153846
636004,78,13,312,156,468,10,0,0.2,3.8,6,27,269,296,0.632478632
636004,78,13,312,156,468,10,0,0.2,4.8,5,55,203,258,0.551282051
636004,78,13,312,156,468,10,0,0.2,5.8,4,24,188,212,0.452991453
636005,78,13,312,156,468,10,0,0.4,1.4,9,92,244,336,0.717948718
636005,78,13,312,156,468,10,0,0.4,2.4,4,35,175,210,0.448717949
636005,78,13,312,156,468,10,0,0.4,3.4,10,85,341,426,0.91025641
636005,78,13,312,156,468,10,0,0.4,4.4,8,-73,415,342,0.730769231
636005,78,13,312,156,468,10,0,0.4,5.4,8,59,249,308,0.658119658
636006,78,13,312,156,468,10,0,0.4,1.6,5,63,185,248,0.52991453
636006,78,13,312,156,468,10,0,0.4,2.6,8,86,266,352,0.752136752
636006,78,13,312,156,468,10,0,0.4,3.6,7,101,241,342,0.730769231
636006,78,13,312,156,468,10,0,0.4,4.6,4,55,183,238,0.508547009
636006,78,13,312,156,468,10,0,0.4,5.6,9,60,352,412,0.88034188
637001,96,10,155,235,390,10,0,0.0,1.0,9,121,210,331,0.848717949
637001,96,10,155,235,390,10,0,0.0,2.0,11,150,225,375,0.961538462
637002,96,10,155,235,390,10,0,0.0,1.0,11,-429,710,281,0.720512821
637002,96,10,155,235,390,10,0,0.0,2.0,12,25,317,342,0.876923077
637003,96,10,155,235,390,10,0,0.0,1.0,7,91,203,294,0.753846154
637003,96,10,155,235,390,10,0,0.0,2.0,8,89,267,356,0.912820513
637004,96,10,155,235,390,10,0,0.0,1.0,8,221,67,288,0.738461538
637004,96,10,155,235,390,10,0,0.0,2.0,7,72,194,266,0.682051282
637005,96,10,155,235,390,10,0,0.0,1.0,8,445,-144,301,0.771794872
637005,96,10,155,235,390,10,0,0.0,2.0,9,315,10,325,0.833333333
639001,112,13,260,416,676,10,1,0.0,0.0,10,257,374,631,0.933431953
639001,112,13,260,416,676,10,1,0.3,1.8,11,272,313,585,0.865384615
639002,112,13,260,416,676,10,1,0.0,0.0,11,193,414,607,0.897928994
639002,112,13,260,416,676,10,1,0.0,2.0,13,351,308,659,0.974852071
639003,112,13,260,416,676,10,1,0.0,0.0,11,251,391,642,0.949704142
639003,112,13,260,416,676,10,1,0.0,2.0,10,266,262,528,0.781065089
639004,112,13,260,416,676,10,1,0.0,0.0,9,253,228,481,0.711538462
639004,112,13,260,416,676,10,1,0.0,2.0,11,282,288,570,0.843195266
639005,112,13,260,416,676,10,1,0.0,0.0,10,269,312,581,0.859467456
639005,112,13,260,416,676,10,1,0.0,1.9,12,223,326,549,0.812130178
641001,80,15,435,435,870,31,0,0.0,15.4838705,12,285,396,681,0.782758621
641001,80,15,435,435,870,31,0,0.0,16.483871,15,270,597,867,0.996551724
641001,80,15,435,435,870,31,0,0.0,17.483871,14,316,523,839,0.964367816
641001,80,15,435,435,870,31,0,0.0,18.483871,13,274,540,814,0.935632184
642001,99,36,1062,1035,2097,25,0,0.0,1.04,27,1053,568,1637,0.780639008
642001,99,36,1062,1035,2097,25,0,0.0,2.04,19,658,474,1132,0.539818789
642001,100,39,1092,1092,2184,26,0,0.0,2.9230769,22,903,361,1264,0.578754579
643001,116,17,306,578,884,12,0,0.0,1.0,17,533,343,876,0.990950226
643002,116,15,270,510,780,10,0,0.0,0.9,14,406,366,772,0.98974359
644001,135,10,356,353,709,13,0,0.0,5.923077,11,511,173,684,0.964739069
644002,121,7,301,189,490,11,0,0.0,6.0,9,480,-82,398,0.812244898
645001,96,10,155,235,390,10,0,0.0,0.0,8,73,280,353,0.905128205
645001,96,10,155,235,390,10,0,0.0,1.0,11,118,267,385,0.987179487
645002,96,10,155,235,390,10,0,0.0,0.0,12,86,251,337,0.864102564
645002,96,10,155,235,390,10,0,0.0,1.0,9,114,208,322,0.825641026
645003,96,10,155,235,390,10,0,0.0,0.0,9,116,253,369,0.946153846
645003,96,10,155,235,390,10,0,0.0,1.0,8,153,131,284,0.728205128
645004,96,10,155,235,390,10,0,0.0,0.0,7,116,193,309,0.792307692
645004,96,10,155,235,390,10,0,0.0,1.0,9,117,169,286,0.733333333
646001,108,650,13670,18897,32567,316,0,0.0,1.0,352,13543,5874,19417,0.59621703
648001,112,13,260,416,676,10,1,0.0,0.0,13,302,338,640,0.946745562
648003,112,13,260,416,676,10,1,0.0,0.0,14,466,194,660,0.976331361
648004,112,13,260,416,676,10,1,0.0,0.0,10,279,315,594,0.878698225
648005,112,13,260,416,676,10,1,0.0,0.0,10,342,216,558,0.825443787
648006,112,13,260,416,676,10,1,0.0,0.0,11,-20,593,573,0.847633136
648007,112,13,260,416,676,10,1,0.0,0.0,11,407,170,577,0.853550296
648008,112,11,223,357,580,8,0,0.0,0.0,7,76,362,438,0.755172414
650001,112,13,260,416,676,10,1,0.0,0.0,4,-10,341,331,0.48964497
650002,112,13,260,416,676,10,1,0.0,0.0,10,76,482,558,0.825443787
652001,112,13,260,416,676,10,1,0.0,0.9,15,153,507,660,0.976331361
652002,112,13,260,416,676,10,1,0.0,1.0,13,189,453,642,0.949704142
652003,112,9,180,288,468,6,0,0.0,1.0,7,149,261,410,0.876068376
654001,112,13,260,416,676,10,1,0.0,0.0,13,629,34,663,0.980769231
654002,112,13,260,416,676,10,1,0.0,0.0,14,339,309,648,0.958579882
654003,112,13,260,416,676,10,1,0.0,0.0,14,-286,944,658,0.973372781
654004,112,13,260,416,676,10,1,0.0,0.0,15,-28,688,660,0.976331361
654005,112,13,260,416,676,10,1,0.0,0.0,10,348,163,511,0.75591716
654006,112,13,260,416,676,10,1,0.0,0.0,13,233,374,607,0.897928994
654007,101,6,195,201,396,5,0,0.0,0.0,5,151,210,361,0.911616162
656001,107,8,176,232,408,6,0,0.0,0.0,4,51,245,296,0.725490196
660001,108,18,450,585,1035,13,0,0.30769232,1.6923077,6,310,215,525,0.507246377
661001,112,13,260,416,676,10,1,1.0,0.0,11,10,572,582,0.860946746
661001,112,13,260,416,676,10,1,1.0,1.0,3,117,138,255,0.377218935
661002,112,13,260,416,676,10,1,1.1,0.0,9,257,309,566,0.837278107
661002,112,13,260,416,676,10,1,1.1,1.0,3,46,161,207,0.306213018
663001,99,39,1170,1134,2304,27,0,0.0,0.0,34,589,1458,2047,0.888454861
665001,112,13,260,416,676,10,1,0.0,1.0,9,214,298,512,0.75739645
665002,112,13,260,416,676,10,1,0.1,0.9,9,131,383,514,0.76035503
666001,65,13,780,390,1170,10,0,0.1,6.4,7,230,685,915,0.782051282
666001,65,13,780,390,1170,10,0,0.1,7.4,8,213,747,960,0.820512821
666002,65,13,780,390,1170,10,0,0.4,6.6,6,207,538,745,0.636752137
666002,65,13,780,390,1170,10,0,0.4,7.6,7,191,639,830,0.709401709
666003,65,13,780,390,1170,10,0,0.8,5.7,8,178,802,980,0.837606838
666003,65,13,780,390,1170,10,0,0.8,6.7,9,252,773,1025,0.876068376
669001,107,44,1606,1562,3168,23,0,0.0,1.0,41,2027,977,3004,0.948232323
671001,520,54,13041,13041,26082,20,0,0.0,2.25,63,11984,9418,21402,0.820565908
671002,448,25,7536,5250,12786,9,0,0.0,1.7777778,27,3927,4614,8541,0.667996246
674001,110,65,1504,2064,3568,50,0,0.0,2.0,66,1653,1719,3372,0.945067265
674002,110,65,1504,2064,3568,50,0,0.0,1.92,58,1388,1588,2976,0.834080717
674003,110,65,1504,2064,3568,50,0,0.0,1.92,64,1611,1731,3342,0.936659193
674004,110,65,1504,2064,3568,50,0,0.0,1.8,54,1451,1417,2868,0.803811659
677001,112,13,260,416,676,10,1,0.0,2.0,8,153,391,544,0.804733728
677002,112,13,260,416,676,10,1,0.7,1.3,11,284,318,602,0.890532544
677003,112,13,260,416,676,10,1,0.1,1.8,9,233,278,511,0.75591716
677004,112,13,260,416,676,10,1,0.5,1.5,7,95,401,496,0.733727811
677005,112,13,260,416,676,10,1,0.1,1.9,4,-73,344,271,0.400887574
679001,123,19,1216,703,1919,15,0,0.0,2.0,16,1152,493,1645,0.857217301
679001,123,19,1216,703,1919,15,0,0.0,3.0,17,680,1153,1833,0.955184992
682001,78,13,312,156,468,10,0,0.5,3.5,11,-258,674,416,0.888888889
682001,78,13,312,156,468,10,0,0.5,4.5,14,86,368,454,0.97008547
682002,78,13,312,156,468,10,0,0.3,4.2,8,83,257,340,0.726495726
682002,78,13,312,156,468,10,0,0.3,5.2,13,145,311,456,0.974358974
682003,78,13,312,156,468,10,0,0.8,4.5,7,38,302,340,0.726495726
682003,78,13,312,156,468,10,0,0.8,5.5,7,18,272,290,0.61965812
682004,78,13,312,156,468,10,0,0.9,3.1,8,156,172,328,0.700854701
682004,78,13,312,156,468,10,0,0.9,4.1,11,160,282,442,0.944444444
682005,80,3,78,48,126,2,0,0.5,2.0,1,53,19,72,0.571428571
684001,100,7,170,170,340,14,0,0.0,0.0,7,142,198,340,1.0
686001,98,36,1205,1088,2293,25,0,0.0,7.72,35,644,1572,2216,0.966419538
688001,260,61,7320,7320,14640,20,0,0.0,0.45,70,4147,6969,11116,0.759289617
688002,248,58,7368,6612,13980,19,0,0.0,0.36842105,55,3477,7075,10552,0.754792561
690001,105,2,65,75,140,6,0,1.0,4.6666665,2,45,95,140,1.0
690001,105,2,65,75,140,6,0,1.0,5.6666665,1,44,21,65,0.464285714
690001,105,2,65,75,140,6,0,1.0,6.6666665,2,70,70,140,1.0
690002,105,2,65,75,140,6,0,0.0,6.8333335,3,-6,126,120,0.857142857
690002,105,2,65,75,140,6,0,0.0,7.8333335,3,156,-36,120,0.857142857
690002,105,2,65,75,140,6,0,0.0,8.833333,2,39,66,105,0.75
690003,105,2,65,75,140,6,0,0.0,7.0,3,-103,223,120,0.857142857
690003,105,2,65,75,140,6,0,0.0,8.0,3,52,68,120,0.857142857
690003,105,2,65,75,140,6,0,0.0,9.0,2,58,82,140,1.0
690004,105,2,65,75,140,6,0,0.0,7.0,3,55,65,120,0.857142857
690004,105,2,65,75,140,6,0,0.0,8.0,3,77,43,120,0.857142857
690004,105,2,65,75,140,6,0,0.0,9.0,3,55,65,120,0.857142857
690005,105,2,65,75,140,6,0,0.0,6.8333335,3,79,41,120,0.857142857
690005,105,2,65,75,140,6,0,0.0,7.8333335,3,46,74,120,0.857142857
690005,105,2,65,75,140,6,0,0.0,8.833333,2,64,76,140,1.0
690006,105,2,65,75,140,6,0,0.5,5.6666665,3,44,76,120,0.857142857
690006,105,2,65,75,140,6,0,0.5,6.6666665,2,75,30,105,0.75
690006,105,2,65,75,140,6,0,0.5,7.6666665,1,16,-11,5,0.035714286
690007,105,2,65,75,140,6,0,0.0,6.0,3,-170,290,120,0.857142857
690007,105,2,65,75,140,6,0,0.0,7.0,2,-35,150,115,0.821428571
690007,105,2,65,75,140,6,0,0.0,8.0,2,17,53,70,0.5
690008,105,2,65,75,140,6,0,0.5,4.8333335,3,-86,206,120,0.857142857
690008,105,2,65,75,140,6,0,0.5,5.8333335,3,3,117,120,0.857142857
690008,105,2,65,75,140,6,0,0.5,6.8333335,2,1,79,80,0.571428571
690009,105,2,65,75,140,6,0,1.0,5.8333335,3,104,16,120,0.857142857
690009,105,2,65,75,140,6,0,1.0,6.8333335,3,-9,129,120,0.857142857
690009,105,2,65,75,140,6,0,1.0,7.8333335,3,73,47,120,0.857142857
691001,489,18,4644,4556,9200,19,0,0.0,4.0526314,17,3926,2866,6792,0.73826087
692001,112,13,260,416,676,10,1,0.0,8.5,8,85,482,567,0.838757396
692002,112,13,260,416,676,10,1,0.0,8.6,7,132,383,515,0.76183432
692003,112,13,260,416,676,10,1,0.0,7.8,8,128,397,525,0.776627219
693001,114,30,645,1050,1695,10,0,0.0,0.3,15,257,822,1079,0.636578171
693001,114,30,645,1050,1695,10,0,0.0,1.3,23,832,631,1463,0.863126844
693002,114,30,645,1050,1695,10,0,0.0,0.0,11,530,246,776,0.457817109
693002,114,30,645,1050,1695,10,0,0.0,1.0,22,773,679,1452,0.856637168
693003,114,30,645,1050,1695,10,0,0.3,0.3,18,528,744,1272,0.750442478
693003,114,30,645,1050,1695,10,0,0.3,1.3,21,481,878,1359,0.801769912
693004,114,30,645,1050,1695,10,0,0.0,0.3,16,525,584,1109,0.654277286
693004,114,30,645,1050,1695,10,0,0.0,1.3,15,165,859,1024,0.604129794
693005,114,30,645,1050,1695,10,0,0.0,0.3,19,350,921,1271,0.749852507
693005,114,30,645,1050,1695,10,0,0.0,1.3,23,478,954,1432,0.844837758
693006,114,30,645,1050,1695,10,0,0.0,0.3,15,713,346,1059,0.624778761
693006,114,30,645,1050,1695,10,0,0.0,1.3,19,814,393,1207,0.712094395
693007,114,30,645,1050,1695,10,0,0.0,0.3,17,395,703,1098,0.647787611
693007,114,30,645,1050,1695,10,0,0.0,1.3,17,-63,1213,1150,0.678466077
693008,114,30,645,1050,1695,10,0,0.1,0.4,12,-261,1147,886,0.522713864
693008,114,30,645,1050,1695,10,0,0.1,1.4,24,1058,335,1393,0.821828909
693009,114,30,645,1050,1695,10,0,0.0,0.0,20,525,773,1298,0.765781711
693009,114,30,645,1050,1695,10,0,0.0,1.0,15,579,516,1095,0.646017699
693010,114,30,645,1050,1695,10,0,0.0,0.3,18,877,394,1271,0.749852507
693010,114,30,645,1050,1695,10,0,0.0,1.3,20,966,398,1364,0.804719764
695001,117,17,289,153,442,31,0,0.7741935,1.8387097,15,312,33,345,0.780542986
695001,117,17,289,153,442,31,0,0.7741935,2.8387096,15,263,156,419,0.947963801
696001,162,3,24,21,45,10,0,0.0,1.8,1,11,4,15,0.333333333
696001,162,3,24,21,45,10,0,0.0,2.8,2,15,25,40,0.888888889
696001,162,3,24,21,45,10,0,0.0,3.8,4,-31,31,0,0.0
696002,162,3,24,21,45,10,0,0.4,1.6,4,37,3,40,0.888888889
696002,162,3,24,21,45,10,0,0.4,2.6,3,-9,34,25,0.555555556
696002,162,3,24,21,45,10,0,0.4,3.6,3,24,1,25,0.555555556
696003,162,3,24,21,45,10,0,0.1,1.9,4,42,-7,35,0.777777778
696003,162,3,24,21,45,10,0,0.1,2.9,3,6,24,30,0.666666667
696003,162,3,24,21,45,10,0,0.1,3.9,3,8,27,35,0.777777778
697001,105,39,895,891,1786,22,0,0.0,0.0,29,489,899,1388,0.777155655
697001,105,37,988,1116,2104,22,0,0.0,1.0,31,573,1367,1940,0.922053232
698001,112,13,260,416,676,10,1,0.0,0.0,9,-256,757,501,0.74112426
698002,112,13,260,416,676,10,1,0.0,0.0,13,329,323,652,0.964497041
699001,514,15,6225,6435,12660,10,0,0.0,1.0,14,1670,10184,11854,0.936334913
699002,514,15,6225,6435,12660,10,0,0.0,1.0,15,9681,2979,12660,1.0
699003,514,15,6225,6435,12660,10,0,0.0,1.0,15,4361,8299,12660,1.0
699004,514,15,6225,6435,12660,10,0,0.0,1.0,15,2962,9698,12660,1.0
699005,514,15,6225,6435,12660,10,0,0.0,1.0,13,1262,9752,11014,0.869984202
699006,514,15,6225,6435,12660,10,0,0.0,1.0,15,7917,4743,12660,1.0
699007,514,15,6225,6435,12660,10,0,0.0,1.0,15,-1121,13781,12660,1.0
699008,514,15,6225,6435,12660,10,0,0.0,1.0,12,6696,3423,10119,0.7992891
699009,514,15,6225,6435,12660,10,0,0.0,1.0,14,3213,8653,11866,0.93728278
699010,514,15,6225,6435,12660,10,0,0.0,1.0,14,2886,8966,11852,0.936176935
699011,514,15,6225,6435,12660,10,0,0.0,1.0,13,1452,9569,11021,0.870537125
699012,514,15,6225,6435,12660,10,0,0.0,1.0,15,11026,1634,12660,1.0
699013,513,12,5010,5166,10176,8,0,0.0,1.0,12,5966,4210,10176,1.0
700001,160,15,21600,1125,22725,10,0,0.0,1.8,15,12868,9857,22725,1.0
700002,160,15,21600,1125,22725,10,0,0.0,2.0,13,14724,6996,21720,0.955775578
700003,160,15,21600,1125,22725,10,0,0.0,2.0,14,6633,16002,22635,0.996039604
700004,355,9,13005,2475,15480,6,0,0.0,2.0,7,3523,10762,14285,0.922803618
701001,105,41,951,820,1771,19,0,0.0,2.0,37,973,687,1660,0.937323546
702001,70,40,420,419,839,60,0,0.0,0.06666667,54,-460,820,360,0.429082241
702001,70,40,420,419,839,60,0,0.0,1.0666667,59,-235,454,219,0.26102503
702002,70,40,420,419,839,60,0,0.0,0.0,50,-229,712,483,0.57568534
702002,70,40,420,419,839,60,0,0.0,1.0,53,-116,437,321,0.382598331
702003,70,40,420,419,839,60,0,0.0,0.0,50,-294,525,231,0.275327771
702003,70,40,420,419,839,60,0,0.0,1.0,55,83,188,271,0.323003576
702004,70,40,420,419,839,60,0,0.0,0.0,50,-880,1137,257,0.306317044
702004,70,40,420,419,839,60,0,0.0,1.0,65,-425,477,52,0.061978546
702005,70,21,246,290,536,32,0,0.0,0.0,19,-56,375,319,0.595149254
702005,70,23,256,309,565,33,0,0.0,0.969697,28,133,211,344,0.608849558
704001,112,13,260,416,676,10,1,0.0,4.0,13,54,619,673,0.99556213
704002,112,13,260,416,676,10,1,0.2,3.8,10,285,302,587,0.868343195
704003,112,13,260,416,676,10,1,0.1,3.8,12,230,393,623,0.921597633
706001,65,13,780,390,1170,10,0,0.0,2.7,9,-507,1432,925,0.790598291
706001,65,13,780,390,1170,10,0,0.0,3.7,12,-73,1193,1120,0.957264957
706002,65,13,780,390,1170,10,0,0.0,3.0,9,183,837,1020,0.871794872
706002,65,13,780,390,1170,10,0,0.0,4.0,9,202,828,1030,0.88034188
706003,65,13,780,390,1170,10,0,0.0,3.0,9,48,912,960,0.820512821
706003,65,13,780,390,1170,10,0,0.0,4.0,10,-4,1034,1030,0.88034188
707001,110,19,384,576,960,14,0,0.0,0.0,10,118,563,681,0.709375
707001,110,19,384,576,960,14,0,0.0,1.0,13,378,426,804,0.8375
707001,110,19,384,576,960,14,0,0.0,2.0,13,328,409,737,0.767708333
708001,120,16,640,640,1280,32,0,0.0,1.03125,16,-154,1434,1280,1.0
709001,110,21,420,630,1050,16,0,0.4375,3.875,22,341,668,1009,0.960952381
709002,110,21,420,630,1050,16,0,0.1875,4.5625,20,371,595,966,0.92
709003,110,21,420,630,1050,16,0,0.5,4.0625,22,268,730,998,0.95047619
709004,110,21,420,630,1050,16,0,0.25,4.4375,20,418,610,1028,0.979047619
709005,110,21,420,630,1050,16,0,0.0,3.75,22,630,404,1034,0.984761905
709006,110,21,420,630,1050,16,0,0.25,4.125,24,-84,1104,1020,0.971428571
709007,110,21,420,630,1050,16,0,0.375,4.3125,18,243,726,969,0.922857143
709009,108,3,78,102,180,2,0,0.5,4.5,3,52,128,180,1.0
710001,107,126,2714,4361,7075,99,0,0.09090909,0.90909094,124,2447,3862,6309,0.891731449
711001,118,14,602,497,1099,10,0,0.6,0.4,14,391,703,1094,0.995450409
712001,114,30,645,1050,1695,20,0,0.0,0.0,26,299,1256,1555,0.91740413
712001,114,30,645,1050,1695,20,0,0.0,1.0,26,666,880,1546,0.912094395
712002,114,30,645,1050,1695,20,0,0.0,0.0,26,327,1228,1555,0.91740413
712002,114,30,645,1050,1695,20,0,0.0,1.0,27,487,1077,1564,0.922713864
712003,114,30,645,1050,1695,20,0,0.0,0.0,27,757,847,1604,0.946312684
712003,114,30,645,1050,1695,20,0,0.0,1.0,25,656,796,1452,0.856637168
712004,114,30,645,1050,1695,20,0,0.0,0.0,27,713,901,1614,0.952212389
712004,114,30,645,1050,1695,20,0,0.0,1.0,29,861,807,1668,0.984070796
712005,114,30,645,1050,1695,20,0,0.0,0.0,26,557,1018,1575,0.92920354
712005,114,30,645,1050,1695,20,0,0.0,1.0,28,648,994,1642,0.968731563
712006,114,30,645,1050,1695,20,0,0.0,0.0,24,841,612,1453,0.857227139
712006,114,30,645,1050,1695,20,0,0.0,1.0,26,1113,386,1499,0.884365782
712007,114,30,645,1050,1695,20,0,0.0,0.0,27,-62,1675,1613,0.951622419
712007,114,30,645,1050,1695,20,0,0.0,1.0,26,195,1390,1585,0.935103245
712008,114,30,645,1050,1695,20,0,0.0,0.0,28,845,795,1640,0.967551622
712008,114,30,645,1050,1695,20,0,0.0,1.0,26,790,784,1574,0.928613569
712009,114,30,645,1050,1695,20,0,0.0,0.0,26,309,1261,1570,0.926253687
712009,114,30,645,1050,1695,20,0,0.0,1.0,28,349,1278,1627,0.959882006
712010,114,30,645,1050,1695,20,0,0.0,0.0,27,880,717,1597,0.942182891
712010,114,30,645,1050,1695,20,0,0.0,1.0,30,490,1205,1695,1.0
714001,112,13,260,416,676,10,1,0.2,1.8,14,96,553,649,0.960059172
714002,112,13,260,416,676,10,1,0.2,1.8,10,440,110,550,0.813609467
714003,112,13,260,416,676,10,1,0.0,2.0,12,81,541,622,0.920118343
714004,112,13,260,416,676,10,1,0.0,2.0,15,-47,707,660,0.976331361
715001,106,3,78,96,174,2,0,0.0,1.0,3,65,109,174,1.0
716001,110,21,420,630,1050,16,0,0.0,2.0,22,689,307,996,0.948571429
716002,110,19,384,576,960,14,0,0.0,1.8571428,16,481,383,864,0.9
717001,83,34,1156,561,1717,41,0,0.0,1.9756098,37,453,1109,1562,0.909726267
717001,83,34,1156,561,1717,41,0,0.0,2.9756098,39,689,827,1516,0.882935352
718001,114,30,645,1050,1695,20,0,0.0,0.2,26,1513,50,1563,0.922123894
718002,114,30,645,1050,1695,20,0,0.0,0.2,28,168,1451,1619,0.955162242
718003,114,30,645,1050,1695,20,0,0.0,0.2,27,469,1144,1613,0.951622419
718004,114,30,645,1050,1695,20,0,0.0,0.0,25,1524,-25,1499,0.884365782
719001,96,10,155,235,390,10,0,0.4,2.7,11,118,267,385,0.987179487
719001,96,10,155,235,390,10,0,0.4,3.7,10,127,240,367,0.941025641
719002,96,10,155,235,390,10,0,0.4,2.5,9,247,31,278,0.712820513
719002,96,10,155,235,390,10,0,0.4,3.5,11,218,146,364,0.933333333
719003,96,10,155,235,390,10,0,0.3,2.7,9,112,135,247,0.633333333
719003,96,10,155,235,390,10,0,0.3,3.7,12,172,171,343,0.879487179
719004,96,10,155,235,390,10,0,0.0,3.0,10,145,156,301,0.771794872
719004,96,10,155,235,390,10,0,0.0,4.0,10,251,54,305,0.782051282
719005,96,10,155,235,390,10,0,0.4,2.7,7,21,287,308,0.78974359
719005,96,10,155,235,390,10,0,0.4,3.7,7,82,223,305,0.782051282
721001,95,10,135,225,360,10,0,0.3,0.7,4,35,154,189,0.525
721001,95,10,135,225,360,10,0,0.3,1.7,8,40,220,260,0.722222222
721002,95,10,135,225,360,10,0,0.7,1.5,2,-110,212,102,0.283333333
721002,95,10,135,225,360,10,0,0.7,2.5,4,-107,191,84,0.233333333
721003,95,10,135,225,360,10,0,0.2,0.8,3,-149,239,90,0.25
721003,95,10,135,225,360,10,0,0.2,1.8,9,273,-26,247,0.686111111
721005,95,10,135,225,360,10,0,0.3,0.7,6,60,97,157,0.436111111
721005,95,10,135,225,360,10,0,0.3,1.7,10,207,53,260,0.722222222
721006,92,4,84,108,192,4,0,0.5,0.5,1,69,3,72,0.375
721007,87,6,111,117,228,5,0,0.2,0.6,5,100,116,216,0.947368421
722001,112,13,260,416,676,10,1,2.7,5.1,10,385,247,632,0.934911243
722001,112,13,260,416,676,10,1,2.7,6.1,10,343,294,637,0.942307692
722002,112,13,260,416,676,10,1,1.4,6.3,9,146,431,577,0.853550296
722002,112,13,260,416,676,10,1,1.4,7.3,8,-146,629,483,0.714497041
722003,112,13,260,416,676,10,1,1.9,4.7,11,422,225,647,0.957100592
722003,112,13,260,416,676,10,1,1.9,5.7,11,499,144,643,0.951183432
723001,112,13,260,416,676,10,1,0.0,0.0,14,-6,663,657,0.971893491
723002,112,13,260,416,676,10,1,0.0,0.0,11,404,188,592,0.875739645
723003,112,13,260,416,676,10,1,0.0,0.1,9,267,291,558,0.825443787
723004,112,13,260,416,676,10,1,0.0,0.0,8,262,164,426,0.630177515
723005,112,13,260,416,676,10,1,0.0,1.2,10,93,403,496,0.733727811
724001,550,5,1130,1130,2260,6,0,0.0,0.0,7,-1763,2687,924,0.408849558
725001,112,13,260,416,676,10,1,2.6,0.9,12,227,420,647,0.957100592
726001,112,15,247,389,636,10,0,0.0,0.0,19,32,569,601,0.944968553
726002,105,16,343,451,794,10,0,0.0,0.0,15,24,750,774,0.974811083
726003,110,18,379,526,905,10,0,0.0,0.0,13,184,622,806,0.890607735
726004,108,17,274,501,775,10,0,0.1,0.7,17,211,525,736,0.949677419
726005,114,17,340,433,773,10,0,0.0,0.0,16,74,678,752,0.972833118
726006,110,16,325,433,758,10,0,0.0,0.4,16,471,238,709,0.935356201
728001,107,15,330,435,765,14,0,0.0,0.0,15,436,326,762,0.996078431
728001,107,15,330,435,765,14,0,0.0,1.0,14,328,428,756,0.988235294
728002,107,15,330,435,765,14,0,0.0,0.0,15,335,406,741,0.968627451
728002,107,15,330,435,765,14,0,0.0,1.0,14,274,477,751,0.981699346
729001,120,6,105,195,300,17,0,0.0,0.0,7,-95,266,171,0.57
729001,120,6,105,195,300,17,0,0.0,1.0,7,-27,267,240,0.8
729001,120,6,105,195,300,17,0,0.0,2.0,7,-125,366,241,0.803333333
729001,120,6,105,195,300,17,0,0.0,3.0,6,3,249,252,0.84
730001,100,26,650,650,1300,20,0,0.1,3.2,26,246,992,1238,0.952307692
730002,100,26,650,650,1300,20,0,0.8,2.45,25,163,1075,1238,0.952307692
730003,100,26,650,650,1300,20,0,0.8,2.75,27,381,895,1276,0.981538462
730004,100,26,650,650,1300,20,0,0.55,2.7,27,413,803,1216,0.935384615
731001,105,6,150,180,330,15,0,0.0,0.0,6,244,56,300,0.909090909
732001,4226,22,56298,43109,99407,16,0,0.0,1.0,8,34915,13266,48181,0.484684177
732001,4226,22,56298,43109,99407,16,0,0.0,2.0,25,33087,48700,81787,0.822748901
733001,662,10,2380,1245,3625,34,0,0.0,7.7941175,12,2265,85,2350,0.648275862
734001,120,26,650,650,1300,20,0,0.0,0.0,23,338,812,1150,0.884615385
734001,120,26,650,650,1300,20,0,0.0,1.0,23,375,789,1164,0.895384615
734001,120,26,650,650,1300,20,0,0.0,2.0,24,521,701,1222,0.94
734002,120,26,650,650,1300,20,0,0.0,0.0,21,662,472,1134,0.872307692
734002,120,26,650,650,1300,20,0,0.0,1.0,28,593,687,1280,0.984615385
734002,120,26,650,650,1300,20,0,0.0,2.0,26,652,582,1234,0.949230769
734003,120,26,650,650,1300,20,0,0.0,0.0,21,599,471,1070,0.823076923
734003,120,26,650,650,1300,20,0,0.0,1.0,24,308,918,1226,0.943076923
734003,120,26,650,650,1300,20,0,0.0,2.0,27,726,548,1274,0.98
734004,120,26,650,650,1300,20,0,0.0,0.0,18,538,416,954,0.733846154
734004,120,26,650,650,1300,20,0,0.0,1.0,22,741,451,1192,0.916923077
734004,120,26,650,650,1300,20,0,0.0,2.0,25,842,370,1212,0.932307692
734005,120,26,650,650,1300,20,0,0.0,0.0,23,698,416,1114,0.856923077
734005,120,26,650,650,1300,20,0,0.0,1.0,25,786,412,1198,0.921538462
734005,120,26,650,650,1300,20,0,0.0,2.0,27,786,458,1244,0.956923077
734006,120,26,650,650,1300,20,0,0.0,0.0,18,423,579,1002,0.770769231
734006,120,26,650,650,1300,20,0,0.0,1.0,27,456,810,1266,0.973846154
734006,120,26,650,650,1300,20,0,0.0,2.0,27,230,1044,1274,0.98
734007,120,26,650,650,1300,20,0,0.0,0.0,20,336,788,1124,0.864615385
734007,120,26,650,650,1300,20,0,0.0,1.0,24,492,716,1208,0.929230769
734007,120,26,650,650,1300,20,0,0.0,2.0,21,440,728,1168,0.898461538
734011,120,3,90,90,180,2,0,0.0,0.0,1,80,20,100,0.555555556
737001,116,17,306,578,884,12,0,0.0,0.0,15,288,562,850,0.961538462
737002,116,17,306,578,884,12,0,0.0,0.0,17,271,593,864,0.977375566
738005,112,13,260,416,676,10,1,1.2,3.0,4,-60,286,226,0.334319527
738005,112,13,260,416,676,10,1,1.2,4.0,4,388,-187,201,0.297337278
738005,112,13,260,416,676,10,1,1.2,5.0,1,53,31,84,0.124260355
738005,112,13,260,416,676,10,1,1.2,6.0,2,161,-11,150,0.221893491
738005,112,13,260,416,676,10,1,1.2,7.0,1,74,4,78,0.115384615
738005,112,13,260,416,676,10,1,1.2,8.0,1,57,21,78,0.115384615
738006,112,13,260,416,676,10,1,0.5,0.3,7,-84,543,459,0.678994083
738006,112,13,260,416,676,10,1,0.5,1.3,11,-277,852,575,0.850591716
738006,112,13,260,416,676,10,1,0.5,2.3,11,-22,563,541,0.800295858
738006,112,13,260,416,676,10,1,0.5,3.3,10,27,508,535,0.791420118
738006,112,13,260,416,676,10,1,0.5,4.3,11,166,425,591,0.874260355
738006,112,13,260,416,676,10,1,0.5,5.3,10,115,425,540,0.798816568
738007,112,11,223,357,580,8,0,0.0,0.0,5,-55,412,357,0.615517241
738007,112,13,260,416,676,10,1,0.0,0.8,7,84,341,425,0.628698225
738007,112,13,260,416,676,10,1,0.0,1.8,9,105,440,545,0.806213018
738007,112,13,260,416,676,10,1,0.0,2.8,7,132,206,338,0.5
738007,112,13,260,416,676,10,1,0.0,3.8,6,108,261,369,0.545857988
738007,112,13,260,416,676,10,1,0.0,4.8,4,43,273,316,0.467455621
740001,94,33,1686,1411,3097,24,0,0.0,3.7916667,26,1336,1197,2533,0.817888279
740002,86,3,154,99,253,3,0,0.0,1.3333334,1,59,123,182,0.719367589
741001,112,13,260,416,676,10,1,0.0,2.7,12,280,309,589,0.871301775
741002,112,13,260,416,676,10,1,0.0,2.9,10,217,298,515,0.76183432
741003,112,13,260,416,676,10,1,0.0,2.9,13,438,206,644,0.952662722
741004,112,13,260,416,676,10,1,0.0,2.9,11,450,161,611,0.903846154
741005,112,13,260,416,676,10,1,0.0,2.8,8,197,229,426,0.630177515
744001,93,22,538,484,1022,19,0,0.0,0.0,22,355,591,946,0.925636008
745001,101,37,907,1072,1979,27,0,0.0,0.0,26,1517,109,1626,0.821627084
745001,101,37,907,1072,1979,27,0,0.0,1.0,35,1515,366,1881,0.95048004
745001,101,37,907,1072,1979,27,0,0.0,2.0,34,1384,414,1798,0.908539666
745001,101,37,907,1072,1979,27,0,0.0,3.0,35,1215,552,1767,0.892875189
745001,101,37,907,1072,1979,27,0,0.0,4.0,31,1053,614,1667,0.842344618
746001,78,13,312,156,468,10,0,0.9,7.6,11,121,281,402,0.858974359
746001,78,13,312,156,468,10,0,0.9,8.6,11,185,201,386,0.824786325
746002,78,13,312,156,468,10,0,1.7,7.9,12,286,160,446,0.952991453
746002,78,13,312,156,468,10,0,1.7,8.9,12,228,234,462,0.987179487
746003,78,13,312,156,468,10,0,1.6,6.5,10,221,191,412,0.88034188
746003,78,13,312,156,468,10,0,1.6,7.5,10,266,132,398,0.85042735
748001,103,234,6148,5606,11754,119,0,0.0,0.0,216,5010,4931,9941,0.845754637
749001,112,13,260,416,676,10,1,0.0,0.0,11,34,524,558,0.825443787
749002,112,13,260,416,676,10,1,0.0,0.0,12,145,464,609,0.900887574
749003,112,13,260,416,676,10,1,0.0,0.0,14,301,345,646,0.955621302
749004,112,13,260,416,676,10,1,0.0,0.0,10,-2,590,588,0.869822485
749005,112,9,180,288,468,6,0,0.0,0.0,4,152,102,254,0.542735043
752001,90,6,195,135,330,10,0,1.0,12.9,6,88,228,316,0.957575758
752001,90,6,195,135,330,10,0,1.0,13.9,4,99,179,278,0.842424242
752002,90,6,195,135,330,10,0,1.3,12.7,5,2,285,287,0.86969697
752002,90,6,195,135,330,10,0,1.3,13.7,6,153,177,330,1.0
752003,90,6,195,135,330,10,0,1.1,13.6,4,119,131,250,0.757575758
752003,90,6,195,135,330,10,0,1.1,14.6,5,83,209,292,0.884848485
754001,112,13,260,416,676,10,1,0.0,0.0,10,191,395,586,0.866863905
758001,112,13,260,416,676,10,1,3.1,1.6,14,252,407,659,0.974852071
760001,96,7,210,266,476,10,0,0.0,4.0,6,74,299,373,0.783613445
760002,96,7,210,266,476,10,0,0.4,4.6,8,365,27,392,0.823529412
760003,96,7,210,266,476,10,0,0.1,4.4,7,-115,510,395,0.829831933
760004,96,7,210,266,476,10,0,0.0,4.5,9,143,298,441,0.926470588
760005,96,7,210,266,476,10,0,0.0,4.5,9,195,246,441,0.926470588
760006,96,7,210,266,476,10,0,0.2,4.3,8,99,326,425,0.892857143
760007,96,7,210,266,476,10,0,0.0,5.0,6,195,216,411,0.863445378
760008,96,7,210,266,476,10,0,0.5,4.5,8,282,159,441,0.926470588
760009,96,7,210,266,476,10,0,0.0,5.0,8,236,106,342,0.718487395
760010,96,7,210,266,476,10,0,0.0,5.0,8,277,147,424,0.890756303
760011,96,7,210,266,476,10,0,0.0,5.0,7,62,304,366,0.768907563
760012,96,7,210,266,476,10,0,0.0,4.5,8,193,243,436,0.915966387
760013,96,7,210,266,476,10,0,0.0,5.0,8,150,222,372,0.781512605
760014,96,7,210,266,476,10,0,0.4,4.2,6,364,36,400,0.840336134
760015,96,7,210,266,476,10,0,0.1,4.9,8,180,231,411,0.863445378
760016,96,7,210,266,476,10,0,0.0,5.0,8,-7,459,452,0.949579832
760017,96,7,210,266,476,10,0,0.5,4.5,8,384,54,438,0.920168067
760018,96,7,210,266,476,10,0,0.4,4.6,8,215,202,417,0.87605042
760019,96,7,210,266,476,10,0,0.0,5.0,8,203,254,457,0.960084034
760020,96,7,210,266,476,10,0,0.0,4.5,8,114,316,430,0.903361345
760021,96,7,210,266,476,10,0,0.0,4.5,9,116,325,441,0.926470588
760023,96,7,210,266,476,10,0,0.0,5.0,9,-74,455,381,0.800420168
760025,73,2,114,85,199,3,0,1.3333334,3.6666667,2,-340,495,155,0.778894472
764001,120,41,820,820,1640,22,0,0.0,0.0,48,280,1216,1496,0.912195122
764002,120,35,703,703,1406,18,0,0.0,0.0,33,730,544,1274,0.906116643
765001,118,9,144,216,360,8,0,0.0,3.0,8,1,341,342,0.95
765002,118,9,144,216,360,8,0,0.375,2.625,8,41,249,290,0.805555556
765003,118,9,144,216,360,8,0,0.375,2.625,9,199,157,356,0.988888889
766001,106,23,506,759,1265,16,0,2.3125,6.75,17,80,1025,1105,0.873517787
766001,106,23,506,759,1265,16,0,2.3125,7.75,22,442,799,1241,0.981027668
766001,106,23,506,759,1265,16,0,2.3125,8.75,23,476,789,1265,1.0
766001,106,23,506,759,1265,16,0,2.3125,9.75,21,445,740,1185,0.936758893
766001,106,23,506,759,1265,16,0,2.3125,10.75,22,496,763,1259,0.995256917
766001,106,23,506,759,1265,16,0,2.3125,11.75,20,461,660,1121,0.886166008
767001,104,55,1450,1485,2935,40,0,0.0,0.0,49,1496,1275,2791,0.950936968
767001,104,55,1450,1485,2935,40,0,0.0,1.0,54,1359,1505,2864,0.975809199
767002,104,55,1450,1485,2935,40,0,0.0,0.0,47,1615,974,2589,0.882112436
767002,104,55,1450,1485,2935,40,0,0.0,1.0,52,1549,1218,2767,0.942759796
767003,104,55,1450,1485,2935,40,0,0.0,0.0,49,1633,1059,2692,0.917206133
767003,104,55,1450,1485,2935,40,0,0.0,1.0,48,1304,1318,2622,0.893356048
767004,104,55,1450,1485,2935,40,0,0.0,0.15,49,1534,1144,2678,0.912436116
767004,104,55,1450,1485,2935,40,0,0.0,1.15,48,1429,1166,2595,0.884156729
767005,104,55,1450,1485,2935,40,0,0.0,0.0,50,1724,915,2639,0.899148211
767005,104,55,1450,1485,2935,40,0,0.0,1.0,44,1582,925,2507,0.854173765
767006,100,41,1137,1045,2182,29,0,0.0,0.0,27,1291,298,1589,0.728230981
767006,100,41,1137,1045,2182,29,0,0.0,1.0,27,401,1289,1690,0.77451879
769001,116,17,306,578,884,18,0,0.0,0.0,15,412,320,732,0.828054299
771001,110,11,220,330,550,8,0,0.375,6.625,9,297,219,516,0.938181818
772001,499,176,35476,35344,70820,181,0,0.0,0.0,233,44026,2650,46676,0.659079356
774001,112,13,260,416,676,10,1,1.8,6.2,12,-322,944,622,0.920118343
774002,112,13,260,416,676,10,1,0.4,8.1,12,-277,910,633,0.936390533
774003,112,13,260,416,676,10,1,0.4,7.2,13,295,345,640,0.946745562
776001,100,16,240,240,480,20,0,0.0,0.0,23,-147,421,274,0.570833333
776001,100,16,240,240,480,20,0,0.0,1.0,23,-205,517,312,0.65
776001,100,16,240,240,480,20,0,0.0,2.0,22,-102,406,304,0.633333333
776001,100,16,240,240,480,20,0,0.0,3.0,18,30,358,388,0.808333333
776002,100,16,240,240,480,20,0,0.0,0.0,14,-85,361,276,0.575
776002,100,16,240,240,480,20,0,0.0,1.0,18,58,328,386,0.804166667
776002,100,16,240,240,480,20,0,0.0,2.0,19,-22,332,310,0.645833333
776002,100,16,240,240,480,20,0,0.0,3.0,20,-30,330,300,0.625
776003,100,16,240,240,480,20,0,0.0,0.0,26,-30,174,144,0.3
776003,100,16,240,240,480,20,0,0.0,1.0,19,269,113,382,0.795833333
776003,100,16,240,240,480,20,0,0.0,2.0,20,144,236,380,0.791666667
776003,100,16,240,240,480,20,0,0.0,3.0,14,266,42,308,0.641666667
776004,100,16,240,240,480,20,0,0.0,0.0,21,-191,491,300,0.625
776004,100,16,240,240,480,20,0,0.0,1.0,18,-105,445,340,0.708333333
776004,100,16,240,240,480,20,0,0.0,2.0,19,38,346,384,0.8
776004,100,16,240,240,480,20,0,0.0,3.0,14,192,194,386,0.804166667
776005,100,16,240,240,480,20,0,0.0,0.0,18,187,161,348,0.725
776005,100,16,240,240,480,20,0,0.0,1.0,21,220,140,360,0.75
776005,100,16,240,240,480,20,0,0.0,2.0,16,179,179,358,0.745833333
776005,100,16,240,240,480,20,0,0.0,3.0,17,162,214,376,0.783333333
776006,100,16,240,240,480,20,0,0.0,0.0,13,-145,465,320,0.666666667
776006,100,16,240,240,480,20,0,0.0,1.0,15,-28,418,390,0.8125
776006,100,16,240,240,480,20,0,0.0,2.0,21,-60,424,364,0.758333333
776006,100,16,240,240,480,20,0,0.0,3.0,17,105,339,444,0.925
776007,100,16,240,240,480,20,0,0.0,0.0,23,-40,248,208,0.433333333
776007,100,16,240,240,480,20,0,0.0,1.0,16,117,211,328,0.683333333
776007,100,16,240,240,480,20,0,0.0,2.0,18,261,133,394,0.820833333
776007,100,16,240,240,480,20,0,0.0,3.0,14,113,245,358,0.745833333
776008,100,16,240,240,480,20,0,0.0,0.0,18,-184,478,294,0.6125
776008,100,16,240,240,480,20,0,0.0,1.0,20,130,170,300,0.625
776008,100,16,240,240,480,20,0,0.0,2.0,19,339,-75,264,0.55
776008,100,16,240,240,480,20,0,0.0,3.0,18,248,128,376,0.783333333
776009,100,16,240,240,480,20,0,0.0,0.0,17,109,261,370,0.770833333
776009,100,16,240,240,480,20,0,0.0,1.0,21,130,232,362,0.754166667
776009,100,16,240,240,480,20,0,0.0,2.0,19,170,234,404,0.841666667
776009,100,16,240,240,480,20,0,0.0,3.0,17,-48,412,364,0.758333333
776010,100,16,240,240,480,20,0,0.0,0.0,15,-18,348,330,0.6875
776010,100,16,240,240,480,20,0,0.0,1.0,17,167,197,364,0.758333333
776010,100,16,240,240,480,20,0,0.0,2.0,19,245,125,370,0.770833333
776010,100,16,240,240,480,20,0,0.0,3.0,18,194,184,378,0.7875
776011,100,16,240,240,480,20,0,0.0,0.0,19,328,26,354,0.7375
776011,100,16,240,240,480,20,0,0.0,1.0,20,199,125,324,0.675
776011,100,16,240,240,480,20,0,0.0,2.0,21,90,208,298,0.620833333
776011,100,16,240,240,480,20,0,0.0,3.0,16,165,175,340,0.708333333
777001,101,44,1138,1126,2264,30,0,0.0,1.3333334,31,775,1019,1794,0.792402827
777001,101,44,1138,1126,2264,30,0,0.0,2.3333333,38,929,1212,2141,0.945671378
777001,101,44,1138,1126,2264,30,0,0.0,3.3333333,37,924,1134,2058,0.909010601
778001,456,7,1498,1540,3038,10,0,0.0,0.0,12,2543,-995,1548,0.509545754
778002,456,7,1498,1540,3038,10,0,0.0,0.7,10,-25,1605,1580,0.520078999
778003,456,7,1498,1540,3038,10,0,0.0,0.0,9,1244,1198,2442,0.803818302
778004,456,7,1498,1540,3038,10,0,0.0,0.0,11,2555,-585,1970,0.64845293
778005,456,7,1498,1540,3038,10,0,0.0,0.0,9,-1379,3505,2126,0.699802502
778006,456,7,1498,1540,3038,10,0,0.0,0.0,11,-175,1839,1664,0.547728769
778007,455,2,490,500,990,2,0,0.0,0.0,1,29,771,800,0.808080808
779001,50,7,182,182,364,20,0,0.0,1.0,9,-54,354,300,0.824175824
780001,107,4,100,126,226,10,0,0.0,5.8,4,75,69,144,0.637168142
780001,107,4,100,126,226,10,0,0.0,6.8,4,122,39,161,0.712389381
780001,107,4,100,126,226,10,0,0.0,7.8,3,48,66,114,0.504424779
780002,107,4,100,126,226,10,0,0.0,6.6,5,-25,235,210,0.92920354
780002,107,4,100,126,226,10,0,0.0,7.6,5,-269,479,210,0.92920354
780002,107,4,100,126,226,10,0,0.0,8.6,5,31,179,210,0.92920354
780003,107,4,100,126,226,10,0,0.0,6.2,5,13,197,210,0.92920354
780003,107,4,100,126,226,10,0,0.0,7.2,3,73,106,179,0.792035398
780003,107,4,100,126,226,10,0,0.0,8.2,3,67,146,213,0.942477876
780004,107,4,100,126,226,10,0,0.0,6.9,4,88,34,122,0.539823009
780004,107,4,100,126,226,10,0,0.0,7.9,2,5,55,60,0.265486726
780004,107,4,100,126,226,10,0,0.0,8.9,3,15,65,80,0.353982301
780005,102,2,84,87,171,5,0,0.0,5.4,2,-38,209,171,1.0
780005,107,4,100,126,226,9,0,0.0,4.888889,4,69,123,192,0.849557522
780005,107,4,100,126,226,10,0,0.0,5.9,3,25,154,179,0.792035398
781001,75,4,58,58,116,10,0,1.0,0.0,8,-12,-22,-34,-0.293103448
781002,75,4,58,58,116,10,0,1.0,0.0,9,-130,62,-68,-0.586206897
781003,75,4,58,58,116,10,0,1.0,0.0,9,-192,117,-75,-0.646551724
781004,75,4,58,58,116,10,0,1.0,0.0,7,-49,91,42,0.362068966
781005,75,4,58,58,116,10,0,1.0,0.0,6,-185,184,-1,-0.00862069
781006,75,4,58,58,116,10,0,1.0,0.0,4,-28,116,88,0.75862069
782001,103,25,725,725,1450,10,0,0.0,0.0,24,675,749,1424,0.982068966
782001,103,25,725,725,1450,10,0,0.0,1.0,24,456,974,1430,0.986206897
782001,103,25,725,725,1450,10,0,0.0,2.0,21,749,581,1330,0.917241379
782002,93,5,215,171,386,3,0,0.0,0.0,5,57,329,386,1.0
782002,93,5,215,171,386,3,0,0.0,1.0,5,243,143,386,1.0
782002,93,5,215,171,386,3,0,0.0,2.0,5,176,186,362,0.937823834
783001,110,11,220,330,550,8,0,0.0,1.0,11,242,294,536,0.974545455
788001,489,14,3920,3920,7840,15,0,0.0,0.0,16,3214,2622,5836,0.744387755
791001,110,13,234,390,624,10,0,0.0,0.0,9,138,391,529,0.84775641
792001,97,8,235,201,436,17,0,0.0,0.0,8,437,-36,401,0.919724771
793001,139,15,600,810,1410,10,0,0.0,0.0,12,634,518,1152,0.817021277
793002,139,15,600,810,1410,10,0,0.0,0.0,15,763,647,1410,1.0
793003,139,15,600,810,1410,10,0,0.0,0.1,11,1084,26,1110,0.787234043
793004,139,15,600,810,1410,10,0,0.0,0.0,12,504,703,1207,0.856028369
795001,108,756,16209,22188,38397,120,0,0.0,0.0,480,2956,24481,27437,0.714561033
795002,111,150,2985,4828,7813,24,0,0.0,0.0,74,2380,2662,5042,0.645334699
796001,90,11,275,275,550,8,0,0.0,0.0,12,200,315,515,0.936363636
797001,515,210,52500,52605,105105,43,0,0.0,4.6511626,156,69571,10324,79895,0.760144617
798001,104,9,234,270,504,7,0,0.0,1.8571428,9,201,303,504,1.0
799001,112,13,260,416,676,10,1,1.0,0.9,15,332,328,660,0.976331361
799002,112,13,260,416,676,10,1,1.0,0.2,14,69,592,661,0.977810651
799003,112,13,260,416,676,10,1,1.0,0.0,14,290,379,669,0.98964497
800001,118,15,270,690,960,10,0,0.0,0.0,14,395,551,946,0.985416667
800002,118,15,270,690,960,10,0,0.0,0.0,14,291,635,926,0.964583333
800003,118,15,270,690,960,10,0,0.0,0.0,15,560,400,960,1.0
800004,118,15,270,690,960,10,0,0.0,0.0,15,152,808,960,1.0
800005,118,15,270,690,960,10,0,0.0,0.0,14,77,873,950,0.989583333
800006,108,9,270,450,720,7,0,0.0,0.0,9,25,653,678,0.941666667
801001,112,13,260,416,676,10,1,0.0,0.0,14,279,378,657,0.971893491
801002,112,13,260,416,676,10,1,0.0,0.0,13,349,295,644,0.952662722
801003,112,13,260,416,676,10,1,0.0,0.0,13,312,326,638,0.943786982
801004,112,13,260,416,676,10,1,0.0,0.3,10,124,400,524,0.775147929
801005,112,13,260,416,676,10,1,0.0,0.0,13,308,341,649,0.960059172
801006,112,13,260,416,676,10,1,0.0,0.0,14,374,280,654,0.967455621
801007,112,13,260,416,676,10,1,0.0,0.0,12,88,525,613,0.906804734
801008,112,13,260,416,676,10,1,0.0,0.0,13,454,210,664,0.982248521
801009,112,13,260,416,676,10,1,0.0,0.0,13,634,26,660,0.976331361
801010,112,13,260,416,676,10,1,0.0,0.0,13,427,216,643,0.951183432
801011,112,13,260,416,676,10,1,0.0,0.0,11,24,521,545,0.806213018
801012,112,13,260,416,676,10,1,0.0,0.0,12,212,420,632,0.934911243
801013,112,13,260,416,676,10,1,0.0,0.0,14,424,221,645,0.954142012
801014,112,13,260,416,676,10,1,0.0,0.0,14,261,398,659,0.974852071
801015,112,13,260,416,676,10,1,0.0,0.0,14,506,148,654,0.967455621
801016,112,9,180,288,468,6,0,0.0,0.0,5,-327,658,331,0.707264957
802001,107,19,703,684,1387,14,0,0.21428572,0.78571427,19,790,553,1343,0.968276857
802002,107,19,703,684,1387,14,0,0.14285715,0.78571427,18,728,582,1310,0.944484499
803001,116,17,306,578,884,12,0,0.0,1.5,15,592,250,842,0.952488688
803002,116,17,306,578,884,12,0,0.0,1.0,15,363,455,818,0.925339367
803003,116,17,306,578,884,12,0,0.0,1.5,15,-384,1200,816,0.923076923
805001,112,13,260,416,676,10,1,0.0,0.0,12,82,540,622,0.920118343
805002,112,13,260,416,676,10,1,0.0,0.0,11,171,409,580,0.857988166
805003,112,13,260,416,676,10,1,0.0,0.0,12,371,283,654,0.967455621
805004,112,13,260,416,676,10,1,0.1,0.5,13,277,376,653,0.965976331
805005,112,13,260,416,676,10,1,0.0,0.0,12,155,461,616,0.911242604
807001,112,13,260,416,676,10,1,0.0,0.0,13,336,290,626,0.926035503
807002,112,13,260,416,676,10,1,0.0,0.0,11,276,322,598,0.884615385
807003,112,13,260,416,676,10,1,0.0,0.0,13,209,422,631,0.933431953
807004,112,13,260,416,676,10,1,0.0,0.0,12,294,362,656,0.970414201
807005,112,13,260,416,676,10,1,0.0,0.0,14,421,251,672,0.99408284
810001,65,13,780,390,1170,10,0,0.8,3.8,13,394,741,1135,0.97008547
810001,65,13,780,390,1170,10,0,0.8,4.8,12,547,593,1140,0.974358974
810002,65,13,780,390,1170,10,0,0.5,4.5,13,355,805,1160,0.991452991
810002,65,13,780,390,1170,10,0,0.5,5.5,14,405,740,1145,0.978632479
810003,65,13,780,390,1170,10,0,0.0,4.9,12,520,525,1045,0.893162393
810003,65,13,780,390,1170,10,0,0.0,5.9,14,645,505,1150,0.982905983
810004,65,13,780,390,1170,10,0,0.4,4.6,11,248,882,1130,0.965811966
810004,65,13,780,390,1170,10,0,0.4,5.6,13,280,880,1160,0.991452991
810005,65,13,780,390,1170,10,0,1.2,3.8,12,116,939,1055,0.901709402
810005,65,13,780,390,1170,10,0,1.2,4.8,11,495,545,1040,0.888888889
811001,80,11,110,165,275,16,0,0.0,0.3125,17,117,-8,109,0.396363636
811002,80,11,110,165,275,16,0,0.0,0.0,12,-27,262,235,0.854545455
811003,80,11,110,165,275,16,0,0.0,0.0,13,-17,223,206,0.749090909
811004,80,11,110,165,275,16,0,0.0,0.0,17,32,103,135,0.490909091
811005,80,11,110,165,275,16,0,0.0,0.0,16,-64,184,120,0.436363636
811006,80,11,110,165,275,16,0,0.0,0.0,11,98,144,242,0.88
811007,80,11,110,165,275,16,0,0.0,0.0,13,-101,309,208,0.756363636
812002,120,1,70,70,140,2,0,2.5,0.0,1,60,80,140,1.0
813001,95,10,135,225,360,10,0,0.0,0.0,10,169,159,328,0.911111111
813002,95,10,135,225,360,10,0,0.3,0.7,9,130,154,284,0.788888889
813003,95,10,135,225,360,10,0,0.0,0.0,8,80,194,274,0.761111111
814001,96,24,300,552,852,10,0,0.3,3.9,20,253,536,789,0.926056338
814001,96,24,300,552,852,10,0,0.3,4.9,23,302,543,845,0.991784038
814001,96,24,300,552,852,10,0,0.3,5.9,21,374,454,828,0.971830986
814002,96,24,300,552,852,10,0,0.0,3.0,18,458,277,735,0.862676056
814002,96,24,300,552,852,10,0,0.0,4.0,22,468,367,835,0.980046948
814002,96,24,300,552,852,10,0,0.0,5.0,23,501,338,839,0.984741784
814003,96,24,300,552,852,10,0,0.0,3.2,12,56,531,587,0.688967136
814003,96,24,300,552,852,10,0,0.0,4.2,16,271,422,693,0.813380282
814003,96,24,300,552,852,10,0,0.0,5.2,12,-15,557,542,0.636150235
814004,89,10,205,252,457,5,0,0.0,3.0,3,-72,261,189,0.41356674
814004,96,15,195,360,555,6,0,0.0,3.8333333,9,258,166,424,0.763963964
814004,96,15,195,360,555,6,0,0.0,4.8333335,8,59,354,413,0.744144144
817001,63,44,1936,946,2882,41,0,0.0,3.9756098,46,980,1758,2738,0.950034698
817001,63,44,1936,946,2882,41,0,0.0,4.97561,46,1202,1542,2744,0.952116586
818001,100,18,594,594,1188,36,0,0.0,6.3333335,12,506,330,836,0.703703704
819001,129,40,739,780,1519,40,0,0.0,0.0,44,1168,171,1339,0.881500987
819002,129,40,739,780,1519,40,0,0.0,0.0,43,825,468,1293,0.851217907
819003,129,40,739,780,1519,40,0,0.0,0.0,43,877,461,1338,0.88084266
819004,129,40,739,780,1519,40,0,0.0,0.0,45,820,557,1377,0.906517446
819005,129,40,739,780,1519,40,0,0.0,0.0,47,651,677,1328,0.874259381
819006,129,40,739,780,1519,40,0,0.0,0.025,41,594,704,1298,0.854509546
819007,129,40,739,780,1519,40,0,0.0,0.0,39,899,322,1221,0.803818302
819008,129,40,739,780,1519,40,0,0.0,0.0,39,243,1088,1331,0.876234365
819009,119,20,487,290,777,19,0,0.0,0.0,11,351,118,469,0.603603604
820001,78,13,312,156,468,10,0,0.6,2.4,9,-239,607,368,0.786324786
820002,78,13,312,156,468,10,0,0.3,2.7,8,199,181,380,0.811965812
820003,78,13,312,156,468,10,0,0.3,2.7,9,67,313,380,0.811965812
820004,78,13,312,156,468,10,0,0.4,2.6,10,-11,439,428,0.914529915
821001,116,30,585,1050,1635,20,0,0.0,0.0,30,779,856,1635,1.0
822001,112,13,260,416,676,10,1,0.0,0.0,9,269,298,567,0.838757396
822001,112,13,260,416,676,10,1,0.0,1.0,10,278,197,475,0.702662722
822001,112,13,260,416,676,10,1,0.0,2.0,14,485,165,650,0.961538462
824001,550,15,3750,3750,7500,20,0,0.0,1.8,19,591,4209,4800,0.64
824002,550,15,3750,3750,7500,20,0,0.0,1.75,21,5326,-2526,2800,0.373333333
824003,550,15,3750,3750,7500,20,0,0.0,1.7,17,-1768,4268,2500,0.333333333
824004,550,15,3750,3750,7500,20,0,0.05,1.45,20,-603,4203,3600,0.48
824005,550,15,3750,3750,7500,20,0,0.0,1.7,18,897,3303,4200,0.56
824006,550,15,3750,3750,7500,20,0,0.1,1.6,20,204,4696,4900,0.653333333
824007,550,15,3750,3750,7500,20,0,0.1,1.5,23,378,2522,2900,0.386666667
824008,550,15,3750,3750,7500,20,0,0.1,1.35,19,619,1481,2100,0.28
824010,550,6,2400,2400,4800,4,0,0.25,1.75,1,380,420,800,0.166666667
825001,112,13,260,416,676,10,1,0.4,0.0,10,-72,698,626,0.926035503
825001,112,13,260,416,676,10,1,0.4,1.0,12,33,624,657,0.971893491
825002,112,13,260,416,676,10,1,0.1,0.0,12,148,496,644,0.952662722
825002,112,13,260,416,676,10,1,0.1,1.0,12,226,410,636,0.940828402
827001,102,56,1502,1708,3210,13,0,0.0,0.15384616,58,1255,1915,3170,0.987538941
831001,100,21,630,630,1260,15,0,0.0,0.0,17,776,302,1078,0.855555556
831001,100,21,630,630,1260,15,0,0.0,1.0,20,852,364,1216,0.965079365
831001,100,21,630,630,1260,15,0,0.0,2.0,19,705,485,1190,0.944444444
832001,112,13,260,416,676,10,1,0.0,4.6,9,169,362,531,0.785502959
832002,112,11,223,357,580,8,0,0.0,4.375,3,-43,295,252,0.434482759
834001,112,13,260,416,676,10,1,0.0,1.0,11,196,442,638,0.943786982
834002,112,13,260,416,676,10,1,0.1,0.9,13,54,606,660,0.976331361
834003,112,13,260,416,676,10,1,0.1,0.9,12,422,237,659,0.974852071
834004,112,13,260,416,676,10,1,0.0,1.0,14,265,404,669,0.98964497
834005,112,13,260,416,676,10,1,0.0,1.0,10,198,343,541,0.800295858
836001,112,13,260,416,676,10,1,0.0,0.0,9,199,276,475,0.702662722
837001,112,13,260,416,676,10,1,0.0,1.0,12,379,222,601,0.889053254
838001,100,50,1275,1275,2550,20,0,0.1,1.9,47,1619,894,2513,0.985490196
838002,100,50,1275,1275,2550,20,0,0.1,1.9,47,616,1896,2512,0.985098039
838003,100,50,1275,1275,2550,20,0,0.5,1.5,42,536,1801,2337,0.916470588
838004,100,50,1275,1275,2550,20,0,0.15,1.85,41,960,1338,2298,0.901176471
838005,100,50,1275,1275,2550,20,0,0.25,1.75,49,916,1629,2545,0.998039216
838006,100,50,1275,1275,2550,20,0,0.2,1.8,44,1019,1418,2437,0.955686275
838007,100,50,1275,1275,2550,20,0,0.1,1.85,42,401,1919,2320,0.909803922
838008,100,50,1275,1275,2550,20,0,0.25,1.75,48,1033,1469,2502,0.981176471
838009,100,50,1275,1275,2550,20,0,0.35,1.65,43,1111,1273,2384,0.934901961
838010,100,50,1275,1275,2550,20,0,0.15,1.85,43,958,1441,2399,0.940784314
838011,100,50,1275,1275,2550,20,0,0.2,1.8,46,1857,636,2493,0.977647059
839001,112,13,260,416,676,10,1,1.2,2.7,8,44,497,541,0.800295858
839002,112,13,260,416,676,10,1,1.0,3.9,8,21,507,528,0.781065089
840001,100,50,1275,1275,2550,10,0,0.0,3.0,37,1185,983,2168,0.850196078
843001,161,15,1350,1140,2490,10,0,1.0,1.9,14,700,1708,2408,0.967068273
843002,161,15,1350,1140,2490,10,0,1.0,1.2,14,416,1985,2401,0.964257028
843003,161,15,1350,1140,2490,10,0,1.0,1.0,14,494,1907,2401,0.964257028
844001,110,3,75,105,180,2,0,0.0,0.0,3,69,111,180,1.0
846001,114,30,645,1050,1695,20,0,0.0,0.0,19,539,677,1216,0.71740413
846001,114,30,645,1050,1695,20,0,0.0,1.0,21,627,726,1353,0.798230088
846001,114,30,645,1050,1695,20,0,0.0,2.0,19,549,595,1144,0.674926254
846001,114,30,645,1050,1695,20,0,0.0,3.0,18,481,667,1148,0.677286136
846002,114,30,645,1050,1695,20,0,0.0,0.0,20,1033,279,1312,0.774041298
846002,114,30,645,1050,1695,20,0,0.0,1.0,25,989,487,1476,0.87079646
846002,114,30,645,1050,1695,20,0,0.0,2.0,22,434,976,1410,0.831858407
846002,114,30,645,1050,1695,20,0,0.0,3.0,23,292,1131,1423,0.839528024
846003,114,30,645,1050,1695,20,0,0.0,0.0,18,-441,1664,1223,0.721533923
846003,114,30,645,1050,1695,20,0,0.0,1.0,19,-109,1340,1231,0.726253687
846003,114,30,645,1050,1695,20,0,0.0,2.0,24,685,734,1419,0.837168142
846003,114,30,645,1050,1695,20,0,0.0,3.0,25,865,647,1512,0.892035398
846005,100,3,120,128,248,3,0,0.0,0.0,1,-150,248,98,0.39516129
847001,110,13,234,390,624,10,0,0.0,0.0,12,107,472,579,0.927884615
847002,110,13,234,390,624,10,0,0.0,0.0,12,294,287,581,0.931089744
847003,110,13,234,390,624,10,0,0.3,0.4,11,200,398,598,0.958333333
847004,110,13,234,390,624,10,0,0.0,0.0,9,254,282,536,0.858974359
850001,112,13,260,416,676,10,1,0.6,2.6,14,109,545,654,0.967455621
850002,112,13,260,416,676,10,1,0.8,3.5,13,249,401,650,0.961538462
850003,112,13,260,416,676,10,1,0.4,3.6,10,123,485,608,0.899408284
850004,112,13,260,416,676,10,1,0.2,3.0,15,370,290,660,0.976331361
850005,112,13,260,416,676,10,1,0.1,4.0,11,288,306,594,0.878698225
851001,116,33,594,1122,1716,23,0,0.0,0.04347826,32,600,1042,1642,0.956876457
853001,110,11,220,330,550,8,0,0.0,0.0,10,201,279,480,0.872727273
853002,100,6,192,192,384,5,0,0.0,0.0,5,456,-110,346,0.901041667
854001,110,65,1504,2064,3568,50,0,0.02,0.24,61,1297,1754,3051,0.855100897
854001,110,65,1504,2064,3568,50,0,0.02,1.24,62,949,2064,3013,0.844450673
854001,110,65,1504,2064,3568,50,0,0.02,2.24,63,1316,1787,3103,0.869674888
854001,110,65,1504,2064,3568,50,0,0.02,3.24,64,1605,1503,3108,0.871076233
854002,110,65,1504,2064,3568,50,0,0.0,0.12,62,1866,1427,3293,0.922926009
854002,110,65,1504,2064,3568,50,0,0.0,1.12,57,643,2334,2977,0.834360987
854002,110,65,1504,2064,3568,50,0,0.0,2.12,65,2164,1134,3298,0.924327354
854002,110,65,1504,2064,3568,50,0,0.0,3.12,65,396,2810,3206,0.898542601
855001,77,10,505,270,775,21,0,0.0,0.8095238,10,543,232,775,1.0
856001,112,13,260,416,676,10,1,0.0,1.0,15,289,371,660,0.976331361
856002,112,13,260,416,676,10,1,0.1,1.7,14,296,361,657,0.971893491
856003,112,13,260,416,676,10,1,0.0,1.0,14,296,354,650,0.961538462
856004,112,13,260,416,676,10,1,0.0,1.0,14,359,301,660,0.976331361
856005,112,13,260,416,676,10,1,0.0,1.4,14,344,323,667,0.986686391
856006,112,13,260,416,676,10,1,0.1,0.9,14,-84,756,672,0.99408284
857001,247,6,168,597,765,10,0,1.1,3.9,9,533,-567,-34,-0.044444444
857002,247,6,168,597,765,10,0,1.1,3.9,4,200,359,559,0.730718954
857003,247,6,168,597,765,10,0,1.1,3.9,6,-621,1386,765,1.0
857004,247,6,168,597,765,10,0,1.2,3.8,9,-96,512,416,0.54379085
860001,112,9,180,288,468,6,0,0.0,0.0,7,448,-24,424,0.905982906
861001,112,13,260,416,676,10,1,0.6,2.4,10,114,495,609,0.900887574
862001,113,13,585,429,1014,10,0,0.0,0.4,14,710,277,987,0.973372781
863001,114,30,645,1050,1695,20,0,0.0,0.0,28,82,1543,1625,0.958702065
863002,114,30,645,1050,1695,20,0,0.0,0.0,26,1082,454,1536,0.90619469
863003,114,30,645,1050,1695,20,0,0.0,0.0,24,-27,1484,1457,0.859587021
863004,114,30,645,1050,1695,20,0,0.0,0.0,29,1071,593,1664,0.981710914
863005,114,30,645,1050,1695,20,0,0.0,0.0,26,-2,1546,1544,0.910914454
863006,114,30,645,1050,1695,20,0,0.0,0.0,28,235,1380,1615,0.95280236
863007,114,30,645,1050,1695,20,0,0.0,0.0,28,860,746,1606,0.947492625
863008,114,30,645,1050,1695,20,0,0.0,0.0,28,550,1083,1633,0.963421829
863009,114,30,645,1050,1695,20,0,0.0,0.0,29,622,1045,1667,0.983480826
864001,100,21,462,581,1043,14,0,0.0,0.0,10,-449,1066,617,0.5915628
864001,99,21,483,628,1111,15,0,0.0,0.93333334,15,248,628,876,0.788478848
864001,99,21,483,628,1111,15,0,0.0,1.9333333,19,690,374,1064,0.95769577
864001,99,21,483,628,1111,15,0,0.0,2.9333334,19,635,440,1075,0.96759676
864001,99,21,483,628,1111,15,0,0.0,3.9333334,18,612,430,1042,0.937893789
865001,115,11,220,550,770,10,0,0.1,3.9,13,-16,752,736,0.955844156
865001,115,11,220,550,770,10,0,0.1,4.9,9,283,428,711,0.923376623
865001,115,11,220,550,770,10,0,0.1,5.9,11,341,411,752,0.976623377
865002,115,11,220,550,770,10,0,0.4,3.6,12,130,617,747,0.97012987
865002,115,11,220,550,770,10,0,0.4,4.6,9,194,478,672,0.872727273
865002,115,11,220,550,770,10,0,0.4,5.6,11,216,503,719,0.933766234
865003,115,11,220,550,770,10,0,0.2,3.8,9,180,387,567,0.736363636
865003,115,11,220,550,770,10,0,0.2,4.8,10,317,332,649,0.842857143
865003,115,11,220,550,770,10,0,0.2,5.8,12,527,184,711,0.923376623
865004,115,11,220,550,770,10,0,0.3,3.7,13,196,525,721,0.936363636
865004,115,11,220,550,770,10,0,0.3,4.7,13,129,616,745,0.967532468
865004,115,11,220,550,770,10,0,0.3,5.7,13,139,612,751,0.975324675
866001,108,9,198,270,468,21,0,0.0,0.0,10,280,180,460,0.982905983
868001,116,34,595,1122,1717,24,0,0.0,1.0,32,539,1138,1677,0.976703553
868001,116,34,595,1122,1717,24,0,0.0,2.0,32,577,1078,1655,0.963890507
868002,116,34,595,1122,1717,24,0,0.29166666,0.7083333,31,715,949,1664,0.969132207
868002,116,34,595,1122,1717,24,0,0.29166666,1.7083334,32,804,842,1646,0.958648806
868003,116,34,595,1122,1717,24,0,0.083333336,0.9166667,34,349,1362,1711,0.996505533
868003,116,34,595,1122,1717,24,0,0.083333336,1.9166666,34,784,899,1683,0.98019802
868004,116,34,595,1122,1717,24,0,0.083333336,0.9166667,32,664,1010,1674,0.974956319
868004,116,34,595,1122,1717,24,0,0.083333336,1.9166666,31,564,1046,1610,0.937682003
868005,116,34,595,1122,1717,24,0,0.041666668,1.0416666,32,437,1247,1684,0.980780431
868005,116,34,595,1122,1717,24,0,0.041666668,2.0416667,29,766,811,1577,0.918462434
868006,116,34,595,1122,1717,24,0,0.125,0.875,32,471,1170,1641,0.95573675
868006,116,34,595,1122,1717,24,0,0.125,1.875,30,556,1051,1607,0.93593477
868007,116,34,595,1122,1717,24,0,0.083333336,0.9166667,35,477,1231,1708,0.994758299
868007,116,34,595,1122,1717,24,0,0.083333336,1.9166666,31,609,955,1564,0.910891089
868008,116,34,595,1122,1717,24,0,0.041666668,0.9583333,32,755,913,1668,0.971461852
868008,116,34,595,1122,1717,24,0,0.041666668,1.9583334,32,639,1022,1661,0.967384974
868009,116,34,595,1122,1717,24,0,0.25,0.75,32,818,848,1666,0.97029703
868009,116,34,595,1122,1717,24,0,0.25,1.75,31,721,896,1617,0.941758882
869001,117,17,731,595,1326,15,0,0.0,0.0,21,1035,189,1224,0.923076923
869002,117,17,731,595,1326,15,0,0.0,0.0,18,268,1034,1302,0.981900452
869003,117,17,731,595,1326,15,0,0.0,0.0,18,652,459,1111,0.83785822
869004,117,17,731,595,1326,15,0,0.0,0.0,19,881,336,1217,0.917797888
869005,117,17,731,595,1326,15,0,0.0,0.0,19,630,545,1175,0.88612368
869006,117,17,731,595,1326,15,0,0.0,0.0,20,167,1043,1210,0.912518854
869007,117,17,731,595,1326,15,0,0.0,0.0,21,646,566,1212,0.914027149
869008,117,17,731,595,1326,15,0,0.0,0.0,17,521,618,1139,0.858974359
869009,117,17,731,595,1326,15,0,0.0,0.0,19,352,901,1253,0.94494721
869010,117,17,731,595,1326,15,0,0.0,0.0,20,177,1027,1204,0.907993967
869011,106,3,177,132,309,3,0,0.0,0.0,1,80,70,150,0.485436893
870001,115,18,324,324,648,50,0,0.0,3.42,17,263,323,586,0.904320988
870001,115,18,324,324,648,50,0,0.0,4.42,18,268,296,564,0.87037037
870001,115,18,324,324,648,50,0,0.0,5.42,18,264,292,556,0.858024691
870002,115,18,324,324,648,50,0,0.0,3.08,17,127,331,458,0.706790123
870002,115,18,324,324,648,50,0,0.0,4.08,19,208,254,462,0.712962963
870002,115,18,324,324,648,50,0,0.0,5.08,17,264,220,484,0.74691358
870003,115,18,324,324,648,50,0,0.08,3.34,19,323,247,570,0.87962963
870003,115,18,324,324,648,50,0,0.08,4.34,18,167,251,418,0.645061728
870003,115,18,324,324,648,50,0,0.08,5.34,18,50,394,444,0.685185185
870004,115,18,324,324,648,39,0,0.0,3.1538463,16,142,402,544,0.839506173
870004,115,18,324,324,648,42,0,0.0,3.952381,15,263,253,516,0.796296296
870004,115,18,324,324,648,42,0,0.0,4.952381,16,181,313,494,0.762345679
871001,112,13,260,416,676,10,1,0.3,2.7,8,155,303,458,0.677514793
871002,112,13,260,416,676,10,1,0.8,2.7,14,256,396,652,0.964497041
871003,112,13,260,416,676,10,1,0.6,2.4,9,161,327,488,0.721893491
871004,112,13,260,416,676,10,1,0.4,2.4,10,0,516,516,0.763313609
873001,107,8,176,232,408,6,0,0.0,1.0,9,384,12,396,0.970588235
873001,107,8,176,232,408,6,0,0.0,2.0,6,241,103,344,0.843137255
875001,78,13,312,156,468,10,0,0.4,9.0,13,150,312,462,0.987179487
875001,78,13,312,156,468,10,0,0.4,10.0,11,220,218,438,0.935897436
875002,78,13,312,156,468,10,0,0.2,8.2,10,351,63,414,0.884615385
875002,78,13,312,156,468,10,0,0.2,9.2,8,217,115,332,0.709401709
875003,78,13,312,156,468,10,0,0.4,7.4,9,6,384,390,0.833333333
875003,78,13,312,156,468,10,0,0.4,8.4,9,113,241,354,0.756410256
875004,78,13,312,156,468,10,0,0.5,9.7,11,56,362,418,0.893162393
875004,78,13,312,156,468,10,0,0.5,10.7,10,124,272,396,0.846153846
877001,65,13,780,390,1170,10,0,0.0,2.6,6,263,572,835,0.713675214
877001,65,13,780,390,1170,10,0,0.0,3.6,9,313,657,970,0.829059829
877002,65,13,780,390,1170,10,0,0.0,2.8,8,213,682,895,0.764957265
877002,65,13,780,390,1170,10,0,0.0,3.8,7,256,639,895,0.764957265
877003,65,13,780,390,1170,10,0,0.0,2.7,7,136,719,855,0.730769231
877003,65,13,780,390,1170,10,0,0.0,3.7,7,104,811,915,0.782051282
877004,65,13,780,390,1170,10,0,0.0,3.0,7,272,578,850,0.726495726
877004,65,13,780,390,1170,10,0,0.0,4.0,7,55,680,735,0.628205128
877005,65,13,780,390,1170,10,0,0.0,3.0,7,40,840,880,0.752136752
877005,65,13,780,390,1170,10,0,0.0,4.0,9,139,906,1045,0.893162393
877006,65,13,780,390,1170,10,0,0.0,2.4,4,-174,734,560,0.478632479
877006,65,13,780,390,1170,10,0,0.0,3.4,8,130,850,980,0.837606838
877007,67,6,378,207,585,4,0,0.0,2.25,1,76,99,175,0.299145299
877007,67,6,378,207,585,4,0,0.0,3.25,2,101,204,305,0.521367521
878001,112,13,260,416,676,10,1,0.2,0.8,10,331,257,588,0.869822485
878002,112,13,260,416,676,10,1,0.2,0.8,12,453,163,616,0.911242604
878003,112,13,260,416,676,10,1,0.0,1.0,13,414,210,624,0.923076923
878004,112,13,260,416,676,10,1,0.1,0.9,13,304,360,664,0.982248521
878005,112,13,260,416,676,10,1,0.1,1.4,13,122,536,658,0.973372781
879001,90,41,820,820,1640,30,0,0.0,0.13333334,29,-47,1392,1345,0.820121951
879001,90,41,820,820,1640,30,0,0.0,1.1333333,33,668,732,1400,0.853658537
879001,90,41,820,820,1640,30,0,0.0,2.1333334,34,214,1203,1417,0.86402439
879001,90,41,820,820,1640,30,0,0.0,3.1333334,37,685,813,1498,0.913414634
879002,90,41,820,820,1640,30,0,0.0,0.26666668,30,568,722,1290,0.786585366
879002,90,41,820,820,1640,30,0,0.0,1.2666667,36,710,762,1472,0.897560976
879002,90,41,820,820,1640,30,0,0.0,2.2666667,36,636,841,1477,0.900609756
879002,90,41,820,820,1640,30,0,0.0,3.2666667,38,1005,523,1528,0.931707317
879003,90,41,820,820,1640,30,0,0.0,0.0,32,-233,1543,1310,0.798780488
879003,90,41,820,820,1640,30,0,0.0,1.0,39,599,912,1511,0.921341463
879003,90,41,820,820,1640,30,0,0.0,2.0,33,197,1184,1381,0.842073171
879003,90,41,820,820,1640,30,0,0.0,3.0,36,696,703,1399,0.85304878
879004,90,41,820,820,1640,30,0,0.0,0.0,29,275,1034,1309,0.798170732
879004,90,41,820,820,1640,30,0,0.0,1.0,35,665,773,1438,0.876829268
879004,90,41,820,820,1640,30,0,0.0,2.0,34,213,1151,1364,0.831707317
879004,90,41,820,820,1640,30,0,0.0,3.0,35,781,629,1410,0.859756098
879005,90,41,820,820,1640,30,0,0.0,0.0,34,418,961,1379,0.840853659
879005,90,41,820,820,1640,30,0,0.0,1.0,34,411,957,1368,0.834146341
879005,90,41,820,820,1640,30,0,0.0,2.0,31,498,799,1297,0.790853659
879005,90,41,820,820,1640,30,0,0.0,3.0,33,597,761,1358,0.82804878
879006,90,41,820,820,1640,30,0,0.0,0.0,32,1026,264,1290,0.786585366
879006,90,41,820,820,1640,30,0,0.0,1.0,34,927,362,1289,0.78597561
879006,90,41,820,820,1640,30,0,0.0,2.0,32,912,368,1280,0.780487805
879006,90,41,820,820,1640,30,0,0.0,3.0,32,961,383,1344,0.819512195
879007,89,24,540,534,1074,17,0,0.0,0.0,10,-1,630,629,0.58566108
879007,89,24,540,534,1074,17,0,0.0,1.0,22,-707,1700,993,0.924581006
879007,89,24,540,534,1074,17,0,0.0,2.0,20,671,251,922,0.858472998
879007,89,24,540,534,1074,17,0,0.0,3.0,14,-252,1010,758,0.705772812
880001,96,10,155,235,390,10,0,0.0,0.0,7,41,291,332,0.851282051
880001,96,10,155,235,390,10,0,0.0,1.0,8,-105,475,370,0.948717949
880002,96,10,155,235,390,10,0,0.0,0.0,11,95,258,353,0.905128205
880002,96,10,155,235,390,10,0,0.0,1.0,9,116,218,334,0.856410256
880003,96,10,155,235,390,10,0,0.0,0.0,11,92,284,376,0.964102564
880003,96,10,155,235,390,10,0,0.0,1.0,11,158,188,346,0.887179487
883001,100,25,650,650,1300,10,0,1.0,4.5,21,380,780,1160,0.892307692
883002,100,25,650,650,1300,10,0,1.0,5.0,22,275,977,1252,0.963076923
884001,120,11,165,385,550,25,0,4.8,5.76,10,124,393,517,0.94
884001,120,11,165,385,550,25,0,4.8,6.76,8,97,242,339,0.616363636
884001,120,11,165,385,550,25,0,4.8,7.76,7,60,248,308,0.56
885001,100,7,170,170,340,14,0,0.0,1.0,7,224,116,340,1.0
886001,112,13,260,416,676,10,1,0.0,0.3,11,390,210,600,0.887573964
886002,112,13,260,416,676,10,1,0.0,0.2,14,431,238,669,0.98964497
886003,112,13,260,416,676,10,1,0.0,0.2,12,493,145,638,0.943786982
886004,112,13,260,416,676,10,1,0.0,0.3,10,413,132,545,0.806213018
886005,112,13,260,416,676,10,1,0.0,0.2,9,274,326,600,0.887573964
886006,112,13,260,416,676,10,1,0.0,0.3,12,366,250,616,0.911242604
886007,112,13,260,416,676,10,1,0.0,0.3,13,582,64,646,0.955621302
886008,112,13,260,416,676,10,1,0.0,0.1,13,418,230,648,0.958579882
886009,112,13,260,416,676,10,1,0.0,0.0,11,153,383,536,0.792899408
886010,112,13,260,416,676,10,1,0.0,0.4,11,437,199,636,0.940828402
886011,112,13,260,416,676,10,1,0.0,0.2,14,343,329,672,0.99408284
886012,112,13,260,416,676,10,1,0.0,0.2,12,278,291,569,0.841715976
886013,112,13,260,416,676,10,1,0.0,0.2,10,198,364,562,0.831360947
886014,112,13,260,416,676,10,1,0.0,0.2,10,265,310,575,0.850591716
886015,112,13,260,416,676,10,1,0.0,0.1,9,134,337,471,0.696745562
890001,127,6,78,87,165,9,0,0.0,2.0,5,-6,111,105,0.636363636
890001,127,6,78,87,165,9,0,0.0,3.0,7,115,46,161,0.975757576
892001,112,13,260,416,676,10,1,0.0,0.0,15,623,46,678,1.0
892002,112,13,260,416,676,10,1,0.0,0.0,12,76,532,608,0.899408284
892003,112,13,260,416,676,10,1,0.0,0.0,13,182,404,586,0.866863905
892004,112,13,260,416,676,10,1,0.0,0.0,13,489,169,658,0.973372781
892005,112,13,260,416,676,10,1,0.0,0.0,14,-60,714,654,0.967455621
892006,112,13,260,416,676,10,1,0.0,0.0,12,165,429,594,0.878698225
892007,112,11,223,357,580,8,0,0.0,0.0,9,149,329,478,0.824137931
894001,112,13,260,416,676,10,1,2.1,0.5,1,54,23,77,0.113905325
896001,98,14,377,360,737,29,0,0.0,1.8965517,14,531,197,728,0.987788331
897001,96,24,300,552,852,10,0,0.0,3.0,22,-220,1032,812,0.953051643
897001,96,24,300,552,852,10,0,0.0,4.0,21,562,218,780,0.915492958
897001,96,24,300,552,852,10,0,0.0,5.0,22,154,678,832,0.976525822
897002,96,20,250,460,710,8,0,0.0,3.75,18,534,166,700,0.985915493
897002,96,20,250,460,710,8,0,0.0,4.75,20,173,537,710,1.0
897002,96,20,250,460,710,8,0,0.0,5.75,20,457,253,710,1.0
898001,114,102,1985,3613,5598,73,0,0.05479452,0.05479452,74,1455,2956,4411,0.787959986
898001,114,102,1985,3613,5598,73,0,0.05479452,1.0547945,96,2530,2783,5313,0.94908896
898001,114,102,1985,3613,5598,73,0,0.05479452,2.0547945,91,2374,2823,5197,0.928367274
898001,114,102,1985,3613,5598,73,0,0.05479452,3.0547945,93,2494,2845,5339,0.953733476
898002,90,3,84,90,174,3,0,0.0,0.0,3,-38,212,174,1.0
898002,90,3,84,90,174,3,0,0.0,1.0,2,12,140,152,0.873563218
898003,90,3,84,90,174,3,0,0.0,0.0,3,7,110,117,0.672413793
898003,90,3,84,90,174,3,0,0.0,1.0,3,79,95,174,1.0
898004,90,3,84,90,174,3,0,0.0,0.0,3,76,41,117,0.672413793
901001,100,3,105,105,210,2,0,0.0,0.0,3,55,155,210,1.0
902001,99,21,693,693,1386,15,0,4.266667,16.066668,10,353,501,854,0.616161616
902001,99,21,693,693,1386,15,0,4.266667,17.066668,11,286,538,824,0.594516595
902001,99,21,693,693,1386,15,0,4.266667,18.066668,13,286,630,916,0.660894661
902001,99,21,693,693,1386,15,0,4.266667,19.066668,10,291,457,748,0.53968254
902001,99,21,693,693,1386,15,0,4.266667,20.066668,13,314,637,951,0.686147186
903001,112,13,260,416,676,10,1,0.0,0.0,14,208,459,667,0.986686391
903001,112,13,260,416,676,10,1,0.0,1.0,11,260,293,553,0.818047337
903002,112,13,260,416,676,10,1,0.0,0.0,12,204,434,638,0.943786982
903002,112,13,260,416,676,10,1,0.0,1.0,13,168,481,649,0.960059172
903003,112,13,260,416,676,10,1,0.0,0.0,8,39,438,477,0.705621302
903003,112,13,260,416,676,10,1,0.0,1.0,10,68,486,554,0.819526627
905001,112,13,260,416,676,10,1,0.0,1.8,8,65,440,505,0.74704142
905002,112,13,260,416,676,10,1,0.0,1.9,13,451,163,614,0.908284024
905003,112,13,260,416,676,10,1,0.0,1.9,9,239,256,495,0.732248521
905004,112,11,223,357,580,8,0,0.0,1.875,9,221,325,546,0.94137931
906001,112,13,260,416,676,10,1,0.0,0.3,14,290,372,662,0.979289941
906002,107,9,225,303,528,7,0,0.0,0.0,9,105,418,523,0.990530303
907001,112,13,260,416,676,10,1,0.2,1.8,11,276,354,630,0.931952663
907002,112,13,260,416,676,10,1,1.1,1.2,9,75,464,539,0.797337278
908001,106,18,450,549,999,13,0,0.0,0.0,7,283,160,443,0.443443443
909001,112,13,260,416,676,10,1,0.0,0.0,9,42,477,519,0.767751479
909001,112,13,260,416,676,10,1,0.0,1.0,11,-99,672,573,0.847633136
910001,95,10,135,225,360,10,0,0.0,1.0,8,67,232,299,0.830555556
910001,95,10,135,225,360,10,0,0.0,2.0,9,1,303,304,0.844444444
910002,95,10,135,225,360,10,0,0.0,1.0,12,-89,383,294,0.816666667
910002,95,10,135,225,360,10,0,0.0,2.0,10,145,113,258,0.716666667
910003,95,10,135,225,360,10,0,0.0,0.9,13,-142,432,290,0.805555556
910003,95,10,135,225,360,10,0,0.0,1.9,13,189,102,291,0.808333333
913001,97,2,25,27,52,2,0,0.0,0.0,3,16,27,43,0.826923077
914001,106,18,450,549,999,13,0,0.0,1.0,14,727,47,774,0.774774775
915001,100,33,1089,1092,2181,23,0,0.0,0.0,18,937,432,1369,0.627693718
915001,101,36,1134,1170,2304,24,0,0.0,0.9583333,30,1376,615,1991,0.864149306
916001,112,13,260,416,676,10,1,0.0,5.0,12,514,128,642,0.949704142
916002,112,13,260,416,676,10,1,0.2,4.4,10,447,109,556,0.822485207
916003,112,13,260,416,676,10,1,0.0,5.0,10,300,297,597,0.883136095
916004,112,13,260,416,676,10,1,0.1,4.9,9,314,274,588,0.869822485
917001,110,13,234,390,624,10,0,0.0,1.0,13,100,504,604,0.967948718
917002,110,13,234,390,624,10,0,0.0,1.0,15,-40,640,600,0.961538462
917003,110,13,234,390,624,10,0,0.0,1.0,14,483,118,601,0.963141026
917004,110,13,234,390,624,10,0,0.0,1.0,14,542,45,587,0.940705128
918001,77,24,624,876,1500,16,0,0.0,0.0,20,669,627,1296,0.864
918002,77,24,624,876,1500,16,0,0.0,0.0,15,63,1078,1141,0.760666667
918003,77,24,624,876,1500,16,0,0.0,0.0,16,-615,1840,1225,0.816666667
918004,77,24,624,876,1500,16,0,0.0,0.0,18,188,1153,1341,0.894
918005,77,24,624,876,1500,16,0,0.0,0.0,19,175,1080,1255,0.836666667
918006,77,24,624,876,1500,16,0,0.0,0.0,19,414,923,1337,0.891333333
918007,77,24,624,876,1500,16,0,0.0,0.0,10,-151,1052,901,0.600666667
918008,77,24,624,876,1500,16,0,0.0,0.0,18,191,1105,1296,0.864
918009,77,24,624,876,1500,16,0,0.0,0.0,11,-167,1046,879,0.586
918010,77,24,624,876,1500,16,0,0.0,0.0,13,16,1084,1100,0.733333333
919001,100,5,150,150,300,2,0,0.0,0.0,5,161,139,300,1.0
920001,108,24,1140,840,1980,17,0,0.0,2.8823528,11,930,162,1092,0.551515152
920001,108,24,1140,840,1980,17,0,0.0,3.8823528,14,1294,137,1431,0.722727273
922001,103,7,167,182,349,20,0,0.0,0.0,10,334,-36,298,0.853868195
924001,127,18,468,774,1242,12,0,0.0,2.0833333,15,182,950,1132,0.911433172
924002,127,18,468,774,1242,12,0,0.0,1.0,15,342,770,1112,0.895330113
926001,100,30,915,915,1830,20,0,0.0,0.0,18,774,531,1305,0.713114754
926001,100,30,915,915,1830,20,0,0.0,1.0,29,1064,736,1800,0.983606557
926001,99,30,945,927,1872,21,0,0.0,1.9047619,29,1176,650,1826,0.97542735
926001,99,30,945,927,1872,21,0,0.0,2.9047618,30,1149,714,1863,0.995192308
930001,103,50,1362,1333,2695,36,0,2.9722223,1.6944444,45,1123,1419,2542,0.9432282
931001,122,21,630,630,1260,8,0,0.0,0.0,19,379,764,1143,0.907142857
931001,122,21,630,630,1260,8,0,0.0,1.0,22,486,759,1245,0.988095238
931001,122,21,630,630,1260,8,0,0.0,2.0,17,508,590,1098,0.871428571
931002,122,21,630,630,1260,8,0,0.0,0.0,17,265,896,1161,0.921428571
931002,122,21,630,630,1260,8,0,0.0,1.0,17,313,710,1023,0.811904762
931002,122,21,630,630,1260,8,0,0.0,2.0,18,379,755,1134,0.9
932001,100,50,1275,1275,2550,10,0,0.0,1.6,38,262,1843,2105,0.825490196
932002,92,20,700,536,1236,5,0,0.0,0.8,18,327,722,1049,0.848705502
933001,90,9,117,180,297,10,0,0.2,3.0,10,26,224,250,0.841750842
933002,90,9,117,180,297,10,0,0.8,1.2,6,98,149,247,0.831649832
933003,90,9,117,180,297,10,0,0.4,2.5,9,32,254,286,0.962962963
933004,90,9,117,180,297,10,0,0.3,2.5,10,58,207,265,0.892255892
934001,112,13,260,416,676,10,1,0.0,3.0,9,552,-37,515,0.76183432
934001,112,13,260,416,676,10,1,0.0,4.0,11,158,355,513,0.75887574
934001,112,13,260,416,676,10,1,0.0,5.0,11,50,485,535,0.791420118
934001,112,13,260,416,676,10,1,0.0,6.0,13,668,-19,649,0.960059172
934002,112,13,260,416,676,10,1,0.0,3.0,13,207,423,630,0.931952663
934002,112,13,260,416,676,10,1,0.0,4.0,9,339,126,465,0.687869822
934002,112,13,260,416,676,10,1,0.0,5.0,8,245,229,474,0.701183432
934002,112,13,260,416,676,10,1,0.0,6.0,9,115,326,441,0.652366864
935001,112,13,260,416,676,10,1,0.0,0.0,12,106,499,605,0.894970414
935003,112,13,260,416,676,10,1,0.0,0.3,10,118,390,508,0.75147929
935004,112,13,260,416,676,10,1,0.0,0.5,12,13,584,597,0.883136095
935005,112,13,260,416,676,10,1,0.0,0.4,9,373,140,513,0.75887574
936001,96,10,155,235,390,10,0,0.5,1.5,9,72,292,364,0.933333333
936001,96,10,155,235,390,10,0,0.5,2.5,10,127,257,384,0.984615385
936002,96,10,155,235,390,10,0,0.4,1.5,10,118,269,387,0.992307692
936002,96,10,155,235,390,10,0,0.4,2.5,9,107,242,349,0.894871795
936003,96,10,155,235,390,10,0,0.3,1.6,10,79,301,380,0.974358974
936003,96,10,155,235,390,10,0,0.3,2.6,9,71,288,359,0.920512821
938001,95,10,135,225,360,10,0,0.0,0.1,9,90,238,328,0.911111111
938001,95,10,135,225,360,10,0,0.0,1.1,11,147,178,325,0.902777778
938002,95,10,135,225,360,10,0,0.0,0.0,8,63,223,286,0.794444444
938002,95,10,135,225,360,10,0,0.0,1.0,11,69,280,349,0.969444444
938003,95,10,135,225,360,10,0,0.0,0.0,8,161,167,328,0.911111111
938003,95,10,135,225,360,10,0,0.0,1.0,11,110,215,325,0.902777778
940001,101,52,1369,1326,2695,37,0,0.0,1.0,49,1768,747,2515,0.933209647
941001,141,9,162,189,351,9,0,0.0,4.0,9,149,202,351,1.0
941001,141,9,162,189,351,9,0,0.0,5.0,10,206,129,335,0.954415954
942001,112,13,260,416,676,10,1,0.0,0.0,9,330,208,538,0.795857988
942002,112,13,260,416,676,10,1,0.0,0.0,13,337,330,667,0.986686391
942003,112,13,260,416,676,10,1,0.2,1.0,11,-62,669,607,0.897928994
943001,112,13,260,416,676,10,1,0.0,0.8,9,255,214,469,0.693786982
943002,112,13,260,416,676,10,1,0.0,0.0,12,136,383,519,0.767751479
943003,112,13,260,416,676,10,1,0.0,0.0,9,547,-4,543,0.803254438
943004,112,13,260,416,676,10,1,0.0,0.0,11,635,-49,586,0.866863905
943005,112,13,260,416,676,10,1,0.0,0.0,13,551,108,659,0.974852071
944005,124,15,375,585,960,10,0,0.0,0.0,14,468,475,943,0.982291667
945001,43,36,672,596,1268,29,0,0.0,1.0,44,80,776,856,0.675078864
946001,112,13,260,416,676,10,1,0.2,2.8,12,547,70,617,0.912721893
946002,112,13,260,416,676,10,1,0.1,2.9,12,35,587,622,0.920118343
946003,112,13,260,416,676,10,1,0.7,2.3,12,361,271,632,0.934911243
946004,112,11,223,357,580,8,0,0.75,2.25,10,-500,1020,520,0.896551724
947001,97,8,235,201,436,17,0,0.0,2.0,7,465,-82,383,0.878440367
948001,575,9,3021,2397,5418,8,0,10.0,0.0,7,-9965,14011,4046,0.746770026
948001,575,9,3021,2397,5418,8,0,10.0,1.0,7,-1426,4993,3567,0.658361019
949001,78,13,312,156,468,10,0,2.5,5.3,8,-49,393,344,0.735042735
949001,78,13,312,156,468,10,0,2.5,6.3,8,-33,389,356,0.760683761
949002,78,13,312,156,468,10,0,1.4,5.8,4,-25,235,210,0.448717949
949002,78,13,312,156,468,10,0,1.4,6.8,7,48,302,350,0.747863248
949003,78,13,312,156,468,10,0,1.2,6.2,9,-103,511,408,0.871794872
949003,78,13,312,156,468,10,0,1.2,7.2,9,-88,446,358,0.764957265
949004,78,13,312,156,468,10,0,1.4,4.9,6,159,135,294,0.628205128
949004,78,13,312,156,468,10,0,1.4,5.9,4,68,168,236,0.504273504
950001,107,15,330,435,765,11,0,0.0,0.90909094,12,406,250,656,0.85751634
950002,107,15,330,435,765,11,0,0.0,0.72727275,13,258,432,690,0.901960784
951001,105,9,261,333,594,7,0,0.0,0.0,5,74,280,354,0.595959596
951001,108,12,300,390,690,8,0,0.0,0.875,8,83,435,518,0.750724638
953001,112,13,260,416,676,10,1,0.0,0.0,13,58,575,633,0.936390533
953002,112,13,260,416,676,10,1,0.0,0.0,13,369,280,649,0.960059172
953003,112,13,260,416,676,10,1,0.0,0.0,14,750,-95,655,0.968934911
953004,112,13,260,416,676,10,1,0.0,0.0,11,408,211,619,0.915680473
953005,112,13,260,416,676,10,1,0.0,0.0,11,138,430,568,0.840236686
953006,112,13,260,416,676,10,1,0.0,0.0,13,129,501,630,0.931952663
953007,112,13,260,416,676,10,1,0.0,0.0,13,268,380,648,0.958579882
953008,112,13,260,416,676,10,1,0.0,0.0,14,81,591,672,0.99408284
953009,112,13,260,416,676,10,1,0.0,0.0,14,456,208,664,0.982248521
953010,112,13,260,416,676,10,1,0.0,0.0,11,174,336,510,0.75443787
953011,112,13,260,416,676,10,1,0.0,0.0,11,373,227,600,0.887573964
953012,112,13,260,416,676,10,1,0.0,0.0,14,349,323,672,0.99408284
953013,112,13,260,416,676,10,1,0.0,0.0,14,208,438,646,0.955621302
953014,112,13,260,416,676,10,1,0.0,0.0,15,520,140,660,0.976331361
953015,112,13,260,416,676,10,1,0.0,0.0,14,403,269,672,0.99408284
953016,112,13,260,416,676,10,1,0.0,0.0,11,377,212,589,0.871301775
953017,112,13,260,416,676,10,1,0.0,0.0,13,368,262,630,0.931952663
953018,112,13,260,416,676,10,1,0.0,0.0,11,179,345,524,0.775147929
953019,112,13,260,416,676,10,1,0.0,0.0,6,199,107,306,0.452662722
953020,111,6,135,201,336,4,0,0.0,0.0,2,204,-12,192,0.571428571
954001,100,7,170,170,340,14,0,0.0,2.0,7,233,107,340,1.0
956001,94,12,342,264,606,12,0,0.33333334,1.6666666,9,74,401,475,0.783828383
956001,94,12,342,264,606,12,0,0.33333334,2.6666667,12,314,278,592,0.97689769
956001,94,12,342,264,606,12,0,0.33333334,3.6666667,12,332,269,601,0.991749175
957001,110,14,287,287,574,10,0,0.0,0.0,11,123,358,481,0.837979094
957001,110,14,287,287,574,10,0,0.0,1.0,12,124,332,456,0.794425087
957002,110,14,287,287,574,10,0,0.0,0.0,13,235,334,569,0.991289199
957002,110,14,287,287,574,10,0,0.0,1.0,14,295,270,565,0.984320557
957003,110,14,287,287,574,10,0,0.0,0.0,13,345,197,542,0.944250871
957003,110,14,287,287,574,10,0,0.0,1.0,14,106,462,568,0.989547038
957004,110,14,287,287,574,10,0,0.0,0.0,10,118,373,491,0.855400697
957004,110,14,287,287,574,10,0,0.0,1.0,12,113,397,510,0.888501742
957005,110,14,287,287,574,10,0,0.0,0.0,10,58,367,425,0.740418118
957005,110,14,287,287,574,10,0,0.0,1.0,14,258,310,568,0.989547038
957006,110,14,287,287,574,10,0,0.0,0.0,10,369,77,446,0.777003484
957006,110,14,287,287,574,10,0,0.0,1.0,11,418,102,520,0.905923345
957007,110,14,287,287,574,10,0,0.0,0.0,13,101,456,557,0.970383275
957007,110,14,287,287,574,10,0,0.0,1.0,13,94,457,551,0.959930314
957008,110,14,287,287,574,10,0,0.0,0.0,12,282,231,513,0.893728223
957008,110,14,287,287,574,10,0,0.0,1.0,10,271,193,464,0.808362369
957009,110,14,287,287,574,10,0,0.0,0.0,13,453,113,566,0.986062718
957009,110,14,287,287,574,10,0,0.0,1.0,12,428,106,534,0.930313589
957010,110,14,287,287,574,10,0,0.0,0.0,13,262,280,542,0.944250871
957010,110,14,287,287,574,10,0,0.0,1.0,14,253,303,556,0.968641115
957011,110,9,198,198,396,6,0,0.0,0.0,9,-139,535,396,1.0
957011,110,9,198,198,396,6,0,0.0,1.0,9,118,278,396,1.0
958001,100,9,234,234,468,7,0,0.0,0.0,6,273,75,348,0.743589744
958001,100,9,234,234,468,7,0,0.0,1.0,8,382,64,446,0.952991453
958001,100,9,234,234,468,7,0,0.0,2.0,9,366,84,450,0.961538462
959001,110,13,234,390,624,10,0,0.0,1.0,11,-110,681,571,0.915064103
959002,110,13,234,390,624,10,0,0.0,1.0,11,-5,550,545,0.873397436
959003,110,13,234,390,624,10,0,0.0,1.0,12,44,548,592,0.948717949
959004,110,13,234,390,624,10,0,0.1,0.9,14,336,259,595,0.953525641
960001,106,97,2477,2852,5329,74,0,0.0,0.0,82,2739,1566,4305,0.807843873
961001,126,24,300,552,852,20,0,0.05,5.45,16,641,49,690,0.809859155
961001,126,24,300,552,852,20,0,0.05,6.45,10,423,105,528,0.61971831
961002,126,24,300,552,852,20,0,0.45,5.3,12,606,-39,567,0.665492958
961002,126,24,300,552,852,20,0,0.45,6.3,11,527,64,591,0.693661972
961003,126,24,300,552,852,20,0,0.3,5.55,9,382,124,506,0.593896714
961003,126,24,300,552,852,20,0,0.3,6.55,10,448,97,545,0.639671362
961004,126,24,300,552,852,20,0,0.3,4.95,10,436,118,554,0.650234742
961004,126,24,300,552,852,20,0,0.3,5.95,10,413,87,500,0.58685446
961005,126,24,300,552,852,20,0,0.5,5.1,14,590,-3,587,0.688967136
961005,126,24,300,552,852,20,0,0.5,6.1,11,498,57,555,0.651408451
961006,126,24,300,552,852,20,0,0.45,5.25,10,282,220,502,0.589201878
961006,126,24,300,552,852,20,0,0.45,6.25,9,303,153,456,0.535211268
961007,126,24,300,552,852,20,0,0.5,4.6,13,474,137,611,0.71713615
961007,126,24,300,552,852,20,0,0.5,5.6,11,454,101,555,0.651408451
961008,126,24,300,552,852,20,0,0.4,5.2,10,414,121,535,0.627934272
961008,126,24,300,552,852,20,0,0.4,6.2,12,538,23,561,0.658450704
961011,125,6,87,144,231,4,0,0.75,4.25,1,81,-11,70,0.303030303
961011,116,6,141,144,285,5,0,1.0,5.0,1,54,11,65,0.228070175
963001,111,12,336,468,804,25,0,0.0,1.0,12,90,686,776,0.965174129
964001,92,9,270,198,468,10,0,0.0,0.0,6,123,233,356,0.760683761
964001,92,9,270,198,468,10,0,0.0,1.0,9,156,262,418,0.893162393
964001,92,9,270,198,468,10,0,0.0,2.0,9,69,317,386,0.824786325
964002,92,9,270,198,468,10,0,0.0,0.0,10,36,284,320,0.683760684
964002,92,9,270,198,468,10,0,0.0,1.0,10,52,338,390,0.833333333
964002,92,9,270,198,468,10,0,0.0,2.0,10,6,335,341,0.728632479
965001,112,13,260,416,676,10,1,0.0,1.0,2,98,75,173,0.25591716
965002,112,13,260,416,676,10,1,0.0,0.9,10,79,476,555,0.821005917
967001,96,10,155,235,390,10,0,0.0,0.0,10,144,235,379,0.971794872
967001,96,10,155,235,390,10,0,0.0,1.0,12,131,232,363,0.930769231
967002,96,10,155,235,390,10,0,0.0,0.0,9,6,310,316,0.81025641
967002,96,10,155,235,390,10,0,0.0,1.0,10,66,306,372,0.953846154
967003,96,10,155,235,390,10,0,0.0,0.0,10,121,246,367,0.941025641
967003,96,10,155,235,390,10,0,0.0,1.0,10,107,251,358,0.917948718
968001,109,110,2058,3292,5350,26,0,0.0,0.0,90,2638,2023,4661,0.871214953
969001,112,13,260,416,676,10,1,0.2,1.8,7,-457,804,347,0.513313609
969002,112,13,260,416,676,10,1,0.0,2.0,11,219,338,557,0.823964497
969003,112,13,260,416,676,10,1,0.2,1.8,11,-247,828,581,0.859467456
972001,96,10,155,235,390,10,0,0.3,1.9,11,99,280,379,0.971794872
972001,96,10,155,235,390,10,0,0.3,2.9,10,142,242,384,0.984615385
972002,96,10,155,235,390,10,0,0.3,0.7,9,309,62,371,0.951282051
972002,96,10,155,235,390,10,0,0.3,1.7,10,203,156,359,0.920512821
972003,96,10,155,235,390,10,0,0.0,1.0,7,43,258,301,0.771794872
972003,96,10,155,235,390,10,0,0.0,2.0,11,123,262,385,0.987179487
973001,65,13,780,390,1170,10,0,0.3,2.7,13,251,899,1150,0.982905983
973002,65,13,780,390,1170,10,0,0.2,3.8,9,103,812,915,0.782051282
973003,65,13,780,390,1170,10,0,0.2,2.8,12,-274,1394,1120,0.957264957
973004,65,13,780,390,1170,10,0,0.2,2.8,13,370,800,1170,1.0
973005,57,6,438,207,645,5,0,0.0,2.6,3,111,204,315,0.488372093
975001,105,22,528,528,1056,45,0,0.0,3.6,21,426,580,1006,0.952651515
975001,105,22,528,528,1056,45,0,0.0,4.6,17,335,485,820,0.776515152
975001,105,22,528,528,1056,45,0,0.0,5.6,17,133,629,762,0.721590909
977001,107,154,3782,4579,8361,122,0,0.0,0.0,144,1076,5965,7041,0.842124148
977001,107,154,3782,4579,8361,122,0,0.0,1.0,142,1963,4966,6929,0.828728621
977001,107,156,3782,4626,8408,123,0,0.032520324,1.9837399,150,2456,5190,7646,0.909372027
977001,107,156,3782,4626,8408,123,0,0.032520324,2.9837399,141,2423,4574,6997,0.832183635
978001,117,20,580,770,1350,10,0,0.0,3.0,16,724,468,1192,0.882962963
978002,116,16,496,624,1120,8,0,0.0,3.0,11,398,518,916,0.817857143
979001,105,6,150,180,330,15,0,2.1333334,7.133333,6,203,117,320,0.96969697
979001,105,6,150,180,330,15,0,2.1333334,8.133333,5,150,154,304,0.921212121
979001,105,6,150,180,330,15,0,2.1333334,9.133333,5,193,97,290,0.878787879
979002,105,6,150,180,330,15,0,2.4666667,6.5333333,5,104,176,280,0.848484848
979002,105,6,150,180,330,15,0,2.4666667,7.5333333,5,201,119,320,0.96969697
979002,105,6,150,180,330,15,0,2.4666667,8.533334,3,103,135,238,0.721212121
979003,104,5,150,170,320,11,0,3.090909,6.818182,5,240,70,310,0.96875
979003,104,5,150,170,320,11,0,3.090909,7.818182,5,172,148,320,1.0
979003,104,5,150,170,320,11,0,3.090909,8.818182,5,174,146,320,1.0
983001,112,13,260,416,676,10,1,0.2,0.9,8,76,367,443,0.655325444
983001,112,13,260,416,676,10,1,0.2,1.9,9,75,474,549,0.812130178
983002,112,13,260,416,676,10,1,0.1,1.2,11,217,343,560,0.828402367
983002,112,13,260,416,676,10,1,0.1,2.2,8,149,321,470,0.695266272
984001,112,13,260,416,676,10,1,0.0,4.0,6,169,227,396,0.585798817
985001,90,11,350,220,570,11,0,0.0,9.0,13,415,116,531,0.931578947
985001,90,11,350,220,570,11,0,0.0,10.0,12,414,115,529,0.928070175
985001,90,11,350,220,570,11,0,0.0,11.0,9,319,187,506,0.887719298
985001,90,11,350,220,570,11,0,0.0,12.0,10,362,208,570,1.0
985001,90,11,350,220,570,11,0,0.0,13.0,10,350,205,555,0.973684211
986001,113,27,648,999,1647,18,0,0.0,0.0,21,994,303,1297,0.78749241
986001,113,27,648,999,1647,18,0,0.0,1.0,23,888,557,1445,0.877352763
986001,113,27,648,999,1647,18,0,0.0,2.0,22,548,883,1431,0.868852459
986001,113,27,648,999,1647,18,0,0.0,3.0,22,912,543,1455,0.883424408
986001,113,27,648,999,1647,18,0,0.0,4.0,23,889,594,1483,0.900425015
987001,110,13,234,390,624,10,0,0.2,0.8,12,118,489,607,0.97275641
988001,96,10,155,235,390,10,0,0.0,0.0,10,203,181,384,0.984615385
988001,96,10,155,235,390,10,0,0.0,1.0,9,180,207,387,0.992307692
988002,96,10,155,235,390,10,0,0.0,0.4,9,57,266,323,0.828205128
988002,96,10,155,235,390,10,0,0.0,1.4,8,66,225,291,0.746153846
988003,96,10,155,235,390,10,0,0.5,0.6,11,78,298,376,0.964102564
988003,96,10,155,235,390,10,0,0.5,1.6,10,45,307,352,0.902564103
988004,96,10,155,235,390,10,0,0.0,0.0,13,160,186,346,0.887179487
988004,96,10,155,235,390,10,0,0.0,1.0,11,179,192,371,0.951282051
988005,96,10,155,235,390,10,0,0.4,0.3,10,155,199,354,0.907692308
988005,96,10,155,235,390,10,0,0.4,1.3,12,161,191,352,0.902564103
988006,94,6,123,159,282,6,0,0.0,0.0,4,131,73,204,0.723404255
988006,94,6,123,159,282,6,0,0.0,1.0,6,160,122,282,1.0
990001,95,10,135,225,360,10,0,0.0,0.0,9,351,-114,237,0.658333333
990001,95,10,135,225,360,10,0,0.0,1.0,12,43,274,317,0.880555556
990002,95,10,135,225,360,10,0,0.0,0.0,11,237,80,317,0.880555556
990002,95,10,135,225,360,10,0,0.0,1.0,8,81,183,264,0.733333333
990003,95,10,135,225,360,10,0,0.0,0.0,7,170,143,313,0.869444444
990003,95,10,135,225,360,10,0,0.0,1.0,9,105,223,328,0.911111111
990004,95,10,135,225,360,10,0,0.0,0.0,9,66,208,274,0.761111111
990004,95,10,135,225,360,10,0,0.0,1.0,12,209,80,289,0.802777778
990005,95,10,135,225,360,10,0,0.0,0.0,10,141,185,326,0.905555556
990005,95,10,135,225,360,10,0,0.0,1.0,10,272,50,322,0.894444444
990006,95,10,135,225,360,10,0,0.0,0.0,8,219,98,317,0.880555556
990006,95,10,135,225,360,10,0,0.0,1.0,10,109,213,322,0.894444444
990007,94,8,128,192,320,8,0,0.0,0.0,4,-84,274,190,0.59375
991001,131,7,70,112,182,10,0,0.3,0.7,11,-119,170,51,0.28021978
991002,131,7,70,112,182,10,0,0.0,1.0,13,334,-364,-30,-0.164835165
991003,131,7,70,112,182,10,0,0.1,0.9,8,182,-47,135,0.741758242
991004,131,7,70,112,182,10,0,0.1,0.9,11,-225,292,67,0.368131868
991005,131,7,70,112,182,10,0,0.0,1.4,8,222,-125,97,0.532967033
991006,131,7,70,112,182,10,0,0.0,0.9,11,517,-471,46,0.252747253
992001,154,60,2049,2070,4119,40,0,0.0,0.975,54,2793,1028,3845,0.933479
992002,154,60,2049,2070,4119,40,0,0.0,1.0,57,2337,1597,3934,0.955086186
992003,154,60,2049,2070,4119,40,0,0.0,1.05,52,2129,1654,3783,0.918426803
992004,154,60,2049,2070,4119,40,0,0.0,0.975,56,1918,2095,4013,0.974265598
992005,154,60,2049,2070,4119,40,0,0.0,0.95,55,1718,2132,3850,0.934692887
992006,154,60,2049,2070,4119,40,0,0.0,0.975,51,2122,1499,3621,0.879096868
992007,154,60,2049,2070,4119,40,0,0.0,1.0,53,1760,1928,3688,0.895362952
992008,154,60,2049,2070,4119,40,0,0.0,0.975,54,2504,1344,3848,0.934207332
992009,151,39,1389,1365,2754,26,0,0.0,0.9230769,24,1432,552,1984,0.720406681
993001,109,20,440,610,1050,8,0,0.0,5.25,15,326,588,914,0.87047619
993001,109,20,440,610,1050,8,0,0.0,2.25,15,332,599,931,0.886666667
993002,109,20,440,610,1050,8,0,0.0,4.75,16,631,331,962,0.916190476
993002,109,20,440,610,1050,8,0,0.0,1.75,13,786,-10,776,0.739047619
994001,78,13,312,156,468,10,0,1.4,8.6,6,42,280,322,0.688034188
994001,78,13,312,156,468,10,0,1.4,9.6,8,127,267,394,0.841880342
994002,78,13,312,156,468,10,0,1.1,7.9,6,44,244,288,0.615384615
994002,78,13,312,156,468,10,0,1.1,8.9,7,30,312,342,0.730769231
994003,78,13,312,156,468,10,0,1.9,7.1,10,-44,468,424,0.905982906
994003,78,13,312,156,468,10,0,1.9,8.1,7,9,293,302,0.645299145
995001,112,13,260,416,676,10,1,0.0,2.0,11,176,406,582,0.860946746
995002,112,13,260,416,676,10,1,0.0,2.0,12,321,330,651,0.963017751
995003,112,13,260,416,676,10,1,0.0,2.4,13,320,323,643,0.951183432
995004,112,13,260,416,676,10,1,0.0,2.2,12,311,247,558,0.825443787
995005,112,13,260,416,676,10,1,0.0,2.0,12,291,330,621,0.918639053
995006,112,9,180,288,468,6,0,1.5,3.1666667,6,201,231,432,0.923076923
998001,112,13,260,416,676,10,1,3.0,0.2,7,221,232,453,0.670118343
998001,112,13,260,416,676,10,1,3.0,1.2,15,549,111,660,0.976331361
998001,112,13,260,416,676,10,1,3.0,2.2,4,169,151,320,0.473372781
998002,112,13,260,416,676,10,1,3.0,0.0,7,10,435,445,0.658284024
998002,112,13,260,416,676,10,1,3.0,1.0,13,238,411,649,0.960059172
998002,112,13,260,416,676,10,1,3.0,2.0,4,213,58,271,0.400887574
998003,111,6,135,201,336,4,0,3.0,0.0,5,274,50,324,0.964285714
999001,112,13,260,416,676,10,1,0.0,0.0,4,101,189,290,0.428994083
1001001,125,26,325,975,1300,30,0,0.0,0.0,25,783,45,828,0.636923077
1001001,125,26,325,975,1300,30,0,0.0,1.0,32,96,1021,1117,0.859230769
1001001,125,26,325,975,1300,30,0,0.0,2.0,31,316,760,1076,0.827692308
1002001,107,3,81,102,183,4,0,0.0,1.0,2,101,-11,90,0.491803279
1002002,107,3,81,102,183,4,0,0.0,1.0,3,133,34,167,0.912568306
1002003,107,3,81,102,183,4,0,0.0,0.75,3,129,15,144,0.786885246
1002004,107,3,81,102,183,4,0,0.0,1.0,2,98,15,113,0.617486339
1002005,107,3,81,102,183,4,0,0.0,1.0,2,34,127,161,0.879781421
1002006,107,3,81,102,183,4,0,0.0,1.0,3,150,33,183,1.0
1002007,107,2,54,68,122,2,0,0.0,1.0,1,90,10,100,0.819672131
1003001,345,6,195,465,660,8,0,1.0,0.0,8,173,311,484,0.733333333
1003002,345,6,195,465,660,8,0,1.0,0.0,6,321,339,660,1.0
1003003,345,6,195,465,660,8,0,1.0,0.0,7,258,260,518,0.784848485
1005001,110,13,234,390,624,10,0,0.0,1.0,10,164,364,528,0.846153846
1005002,110,13,234,390,624,10,0,0.6,1.1,11,375,211,586,0.939102564
1005003,110,13,234,390,624,10,0,0.5,1.0,9,158,324,482,0.772435897
1005004,110,13,234,390,624,10,0,0.1,0.9,11,57,471,528,0.846153846
1007001,97,21,882,861,1743,14,0,0.0,0.0,21,1129,614,1743,1.0
1008001,112,13,260,416,676,10,1,0.0,0.0,8,103,403,506,0.74852071
1008001,112,13,260,416,676,10,1,0.0,1.0,11,109,517,626,0.926035503
1008001,112,13,260,416,676,10,1,0.0,2.0,9,111,490,601,0.889053254
1008002,112,13,260,416,676,10,1,0.0,0.0,9,215,391,606,0.896449704
1008002,112,13,260,416,676,10,1,0.0,1.0,10,175,465,640,0.946745562
1008002,112,13,260,416,676,10,1,0.0,2.0,11,148,492,640,0.946745562
1009001,112,13,260,416,676,10,1,0.0,1.0,12,556,46,602,0.890532544
1009001,112,13,260,416,676,10,1,0.0,2.0,14,453,208,661,0.977810651
1009002,112,13,260,416,676,10,1,0.0,1.0,14,134,521,655,0.968934911
1009002,112,13,260,416,676,10,1,0.0,2.0,14,422,235,657,0.971893491
1009002,112,13,260,416,676,10,1,0.0,3.0,1,18,68,86,0.127218935
1009003,112,13,260,416,676,10,1,0.0,1.0,9,-6,527,521,0.770710059
1009003,112,13,260,416,676,10,1,0.0,2.0,12,-428,1084,656,0.970414201
1009004,112,13,260,416,676,10,1,0.0,1.0,7,173,267,440,0.650887574
1009004,112,13,260,416,676,10,1,0.0,2.0,9,-660,1050,390,0.576923077
1009005,112,9,180,288,468,6,0,0.0,0.8333333,1,0,87,87,0.185897436
1010001,108,12,270,366,636,9,0,0.0,0.0,12,218,383,601,0.944968553
1011001,105,12,276,330,606,9,0,0.0,0.0,12,183,408,591,0.975247525
1011002,105,12,276,330,606,9,0,0.0,0.0,12,61,485,546,0.900990099
1011003,105,12,276,330,606,9,0,0.0,0.0,12,242,334,576,0.95049505
1013001,112,13,260,416,676,10,1,0.0,1.9,11,409,122,531,0.785502959
1013002,112,13,260,416,676,10,1,0.0,1.7,10,542,63,605,0.894970414
1014001,50,26,650,650,1300,20,0,0.0,4.0,22,409,769,1178,0.906153846
1016001,110,21,420,630,1050,15,0,0.0,1.0,21,284,751,1035,0.985714286
1018001,112,13,260,416,676,10,1,0.3,2.5,11,276,327,603,0.892011834
1018002,112,13,260,416,676,10,1,0.2,2.4,10,211,388,599,0.886094675
1018003,112,13,260,416,676,10,1,0.5,2.3,10,264,299,563,0.832840237
1018004,112,13,260,416,676,10,1,0.5,2.0,12,159,433,592,0.875739645
1018005,112,13,260,416,676,10,1,0.3,3.2,12,51,545,596,0.881656805
1018006,112,13,260,416,676,10,1,0.4,2.6,11,140,500,640,0.946745562
1018007,112,13,260,416,676,10,1,0.2,2.8,11,253,379,632,0.934911243
1019001,112,13,260,416,676,10,1,0.0,3.5,11,264,267,531,0.785502959
1019002,112,13,260,416,676,10,1,0.0,4.7,8,139,379,518,0.766272189
1019003,112,13,260,416,676,10,1,0.0,3.6,13,714,-56,658,0.973372781
1019004,112,13,260,416,676,10,1,0.0,3.6,10,201,393,594,0.878698225
1019005,112,13,260,416,676,10,1,0.0,3.8,8,244,321,565,0.835798817
1019006,112,13,260,416,676,10,1,0.0,2.8,9,299,267,566,0.837278107
1020001,108,215,4401,6368,10769,167,0,0.0,0.0,103,418,5586,6004,0.557526233
1021001,123,9,135,207,342,10,0,0.7,3.0,9,215,21,236,0.69005848
1021002,123,9,135,207,342,10,0,0.3,3.0,10,179,60,239,0.698830409
1021003,123,9,135,207,342,10,0,0.5,3.4,11,393,-113,280,0.81871345
1021004,123,9,135,207,342,10,0,0.8,3.1,8,160,158,318,0.929824561
1022001,112,13,260,416,676,10,1,0.0,2.0,9,-62,516,454,0.671597633
1022002,112,13,260,416,676,10,1,0.2,1.8,11,381,204,585,0.865384615
1022003,112,13,260,416,676,10,1,0.0,2.0,15,220,440,660,0.976331361
1022004,112,13,260,416,676,10,1,0.1,1.9,15,-136,796,660,0.976331361
1022005,112,13,260,416,676,10,1,0.0,2.0,14,-217,878,661,0.977810651
1022006,112,13,260,416,676,10,1,0.2,1.8,12,574,34,608,0.899408284
1022007,112,13,260,416,676,10,1,0.1,1.9,14,357,286,643,0.951183432
1022008,112,13,260,416,676,10,1,0.1,1.9,12,537,-48,489,0.723372781
1022009,112,13,260,416,676,10,1,0.0,2.0,14,177,495,672,0.99408284
1023001,108,18,450,585,1035,13,0,0.0,2.0,15,1135,-220,915,0.884057971
1026001,122,10,145,190,335,14,0,0.5,1.4285715,10,298,-9,289,0.862686567
1026002,122,10,145,190,335,14,0,0.21428572,1.7857143,9,166,161,327,0.976119403
1027001,99,33,1023,999,2022,23,0,0.0,0.2173913,22,1233,259,1492,0.737883284
1027001,99,33,1023,999,2022,23,0,0.0,1.2173913,27,1489,254,1743,0.862017804
1027001,99,33,1023,999,2022,23,0,0.0,2.2173913,26,1325,359,1684,0.832838773
1027001,99,33,1023,999,2022,23,0,0.0,3.2173913,29,1359,511,1870,0.924826904
1027001,99,33,1023,999,2022,23,0,0.0,4.2173915,31,1525,433,1958,0.96834817
1028001,108,9,198,270,468,10,0,2.0,10.8,5,54,254,308,0.658119658
1028001,108,9,198,270,468,10,0,2.0,11.8,8,96,353,449,0.959401709
1028002,108,9,198,270,468,10,0,2.3,10.5,8,105,359,464,0.991452991
1028002,108,9,198,270,468,10,0,2.3,11.5,4,78,207,285,0.608974359
1028003,108,9,198,270,468,10,0,2.2,10.6,5,163,190,353,0.754273504
1028003,108,9,198,270,468,10,0,2.2,11.6,7,172,236,408,0.871794872
1031001,112,15,330,510,840,11,0,0.09090909,0.09090909,9,-44,686,642,0.764285714
1031001,116,17,306,578,884,12,0,0.083333336,1.0,16,194,660,854,0.966063348
1034001,110,38,969,806,1775,38,0,0.0,1.0263158,40,975,496,1471,0.828732394
1037001,78,13,312,156,468,10,0,0.1,7.8,6,167,149,316,0.675213675
1037001,78,13,312,156,468,10,0,0.1,8.8,5,58,178,236,0.504273504
1037002,78,13,312,156,468,10,0,0.4,8.8,6,58,272,330,0.705128205
1037002,78,13,312,156,468,10,0,0.4,9.8,7,55,289,344,0.735042735
1037003,78,13,312,156,468,10,0,0.4,7.7,8,-126,516,390,0.833333333
1037003,78,13,312,156,468,10,0,0.4,8.7,6,-17,323,306,0.653846154
1037004,78,13,312,156,468,10,0,0.6,6.6,4,31,189,220,0.47008547
1037004,78,13,312,156,468,10,0,0.6,7.6,5,46,242,288,0.615384615
1038001,112,17,442,442,884,8,0,0.375,2.625,13,284,383,667,0.754524887
1038001,112,17,442,442,884,8,0,0.375,3.625,15,265,539,804,0.909502262
1038001,112,17,442,442,884,8,0,0.375,4.625,16,211,585,796,0.900452489
1038001,112,17,442,442,884,8,0,0.375,5.625,15,319,383,702,0.794117647
1038002,112,17,442,442,884,8,0,0.75,1.875,4,120,163,283,0.320135747
1038002,112,17,442,442,884,8,0,0.75,2.875,11,365,276,641,0.725113122
1038002,112,17,442,442,884,8,0,0.75,3.875,12,429,312,741,0.838235294
1038002,112,17,442,442,884,8,0,0.75,4.875,12,348,342,690,0.780542986
1040001,112,13,260,416,676,10,1,0.4,1.6,13,98,510,608,0.899408284
1040002,112,13,260,416,676,10,1,0.0,2.0,10,222,309,531,0.785502959
1040003,112,13,260,416,676,10,1,0.2,1.8,11,173,436,609,0.900887574
1041001,78,13,312,156,468,10,0,0.8,8.7,11,-43,473,430,0.918803419
1041001,78,13,312,156,468,10,0,0.8,9.7,10,56,346,402,0.858974359
1041002,78,13,312,156,468,10,0,0.2,10.2,14,157,303,460,0.982905983
1041002,78,13,312,156,468,10,0,0.2,11.2,12,-2,466,464,0.991452991
1041003,78,13,312,156,468,10,0,0.3,8.7,11,96,354,450,0.961538462
1041003,78,13,312,156,468,10,0,0.3,9.7,8,146,182,328,0.700854701
1041004,78,13,312,156,468,10,0,1.8,10.0,11,153,275,428,0.914529915
1041004,78,13,312,156,468,10,0,1.8,11.0,12,127,259,386,0.824786325
1042001,112,13,260,416,676,10,1,0.1,3.8,12,352,277,629,0.930473373
1042002,112,13,260,416,676,10,1,0.2,2.8,10,-101,627,526,0.778106509
1042003,112,13,260,416,676,10,1,0.2,2.8,13,48,588,636,0.940828402
1042004,112,13,260,416,676,10,1,0.4,2.6,10,347,183,530,0.784023669
1042005,112,13,260,416,676,10,1,0.4,2.6,14,25,641,666,0.985207101
1044001,100,36,1116,1116,2232,18,0,0.0,3.0,30,1286,686,1972,0.883512545
1045001,112,13,260,416,676,10,1,0.0,1.0,12,614,48,662,0.979289941
1045002,112,13,260,416,676,10,1,0.0,1.0,12,549,84,633,0.936390533
1045003,112,13,260,416,676,10,1,0.0,1.0,10,475,78,553,0.818047337
1045004,112,13,260,416,676,10,1,0.0,1.0,12,350,239,589,0.871301775
1045005,112,13,260,416,676,10,1,0.0,1.0,11,565,-25,540,0.798816568
1045006,112,13,260,416,676,10,1,0.0,1.0,12,438,182,620,0.917159763
1045007,112,13,260,416,676,10,1,0.0,1.0,9,245,266,511,0.75591716
1045008,112,13,260,416,676,10,1,0.0,1.0,11,820,-210,610,0.902366864
1045009,112,13,260,416,676,10,1,0.0,1.0,9,400,110,510,0.75443787
1045010,112,13,260,416,676,10,1,0.0,1.0,11,688,-91,597,0.883136095
1045011,112,13,260,416,676,10,1,0.0,1.0,12,655,-10,645,0.954142012
1045012,112,13,260,416,676,10,1,0.0,1.0,12,455,143,598,0.884615385
1045013,112,13,260,416,676,10,1,0.0,1.0,12,404,236,640,0.946745562
1045014,112,13,260,416,676,10,1,0.0,1.0,10,689,-82,607,0.897928994
1045015,112,13,260,416,676,10,1,0.0,1.0,9,237,255,492,0.727810651
1045016,112,13,260,416,676,10,1,0.0,1.0,7,308,128,436,0.644970414
1045017,112,13,260,416,676,10,1,0.0,1.0,4,184,147,331,0.48964497
1045018,112,13,260,416,676,10,1,0.0,1.0,2,136,30,166,0.24556213
1048002,110,15,450,708,1158,11,0,0.0,0.0,8,301,376,677,0.58462867
1048002,110,15,450,708,1158,11,0,0.0,1.0,12,351,563,914,0.789291883
1048002,110,15,450,708,1158,11,0,0.0,2.0,12,401,546,947,0.817789292
1049001,112,13,260,416,676,10,1,0.0,0.0,12,57,558,615,0.909763314
1049002,112,13,260,416,676,10,1,0.0,0.0,13,75,576,651,0.963017751
1049003,111,6,135,201,336,4,0,0.0,0.0,3,51,169,220,0.654761905
1051001,110,13,234,390,624,10,0,0.0,2.0,12,183,431,614,0.983974359
1051002,110,13,234,390,624,10,0,0.0,2.0,13,278,337,615,0.985576923
1051003,110,13,234,390,624,10,0,0.0,2.0,11,254,258,512,0.820512821
1051004,110,13,234,390,624,10,0,0.0,2.0,13,173,431,604,0.967948718
1052001,124,27,351,351,702,20,0,0.0,1.0,20,128,468,596,0.849002849
1052002,119,3,63,52,115,3,0,0.0,1.0,1,25,26,51,0.443478261
1053001,107,15,330,435,765,11,0,0.0,1.9090909,12,357,341,698,0.912418301
1053002,107,15,330,435,765,11,0,0.0,1.7272727,10,234,363,597,0.780392157
1054001,100,15,495,495,990,10,0,5.1,3.4,11,278,487,765,0.772727273
1054001,100,15,495,495,990,10,0,5.1,4.4,3,48,173,221,0.223232323
1054001,100,15,495,495,990,10,0,5.1,5.4,8,244,312,556,0.561616162
1054001,100,15,495,495,990,10,0,5.1,6.4,5,-49,447,398,0.402020202
1054001,100,15,495,495,990,10,0,5.1,7.4,6,65,354,419,0.423232323
1054001,100,15,495,495,990,10,0,5.1,8.4,9,-81,704,623,0.629292929
1055001,106,18,450,549,999,13,0,0.0,3.0,5,422,-114,308,0.308308308
1056001,112,13,260,416,676,10,1,0.8,4.6,11,73,482,555,0.821005917
1056002,112,13,260,416,676,10,1,0.0,4.6,13,331,342,673,0.99556213
1056003,112,13,260,416,676,10,1,0.2,5.8,11,342,249,591,0.874260355
1060001,114,30,645,1050,1695,20,0,0.1,0.9,24,345,1201,1546,0.912094395
1060001,114,30,645,1050,1695,20,0,0.1,1.9,26,56,1515,1571,0.926843658
1060002,114,30,645,1050,1695,20,0,0.15,0.85,26,857,719,1576,0.92979351
1060002,114,30,645,1050,1695,20,0,0.15,1.85,27,945,660,1605,0.946902655
1060003,114,30,645,1050,1695,20,0,0.45,0.55,24,294,1126,1420,0.837758112
1060003,114,30,645,1050,1695,20,0,0.45,1.55,25,76,1456,1532,0.903834808
1060004,114,30,645,1050,1695,20,0,0.35,0.65,26,801,765,1566,0.923893805
1060004,114,30,645,1050,1695,20,0,0.35,1.65,24,839,649,1488,0.877876106
1060005,114,30,645,1050,1695,20,0,0.15,0.85,22,320,1024,1344,0.792920354
1060005,114,30,645,1050,1695,20,0,0.15,1.85,24,378,1105,1483,0.874926254
1060006,114,30,645,1050,1695,20,0,0.25,0.7,28,691,937,1628,0.960471976
1060006,114,30,645,1050,1695,20,0,0.25,1.7,22,846,551,1397,0.824188791
1060007,114,30,645,1050,1695,20,0,0.1,0.9,27,788,801,1589,0.937463127
1060007,114,30,645,1050,1695,20,0,0.1,1.9,27,743,863,1606,0.947492625
1060008,114,30,645,1050,1695,20,0,0.25,0.75,23,784,647,1431,0.844247788
1060008,114,30,645,1050,1695,20,0,0.25,1.75,26,1038,527,1565,0.923303835
1060009,114,30,645,1050,1695,20,0,0.35,0.65,28,1124,519,1643,0.969321534
1060009,114,30,645,1050,1695,20,0,0.35,1.65,22,1006,463,1469,0.866666667
1060010,114,30,645,1050,1695,20,0,0.4,0.6,25,507,978,1485,0.876106195
1060010,114,30,645,1050,1695,20,0,0.4,1.6,28,479,1162,1641,0.968141593
1060011,114,30,645,1050,1695,20,0,0.35,0.65,25,494,1043,1537,0.906784661
1060011,114,30,645,1050,1695,20,0,0.35,1.65,25,374,1139,1513,0.892625369
1060012,114,30,645,1050,1695,20,0,0.2,0.8,20,691,622,1313,0.774631268
1060012,114,30,645,1050,1695,20,0,0.2,1.8,20,951,302,1253,0.739233038
1060020,100,3,120,128,248,3,0,0.0,0.0,2,30,136,166,0.669354839
1060020,100,3,120,128,248,3,0,0.0,1.0,1,50,48,98,0.39516129
1061001,65,13,780,390,1170,10,0,1.1,5.2,11,164,931,1095,0.935897436
1061001,65,13,780,390,1170,10,0,1.1,6.2,11,275,830,1105,0.944444444
1061002,65,13,780,390,1170,10,0,1.0,5.2,12,393,747,1140,0.974358974
1061002,65,13,780,390,1170,10,0,1.0,6.2,12,559,556,1115,0.952991453
1061003,65,13,780,390,1170,10,0,0.7,5.5,13,352,793,1145,0.978632479
1061003,65,13,780,390,1170,10,0,0.7,6.5,12,447,698,1145,0.978632479
1063003,107,9,225,303,528,7,0,0.0,5.0,2,56,121,177,0.335227273
1063003,107,9,225,303,528,7,0,0.0,6.0,7,205,170,375,0.710227273
1063003,107,9,225,303,528,7,0,0.0,7.0,5,136,158,294,0.556818182
1063003,107,9,225,303,528,7,0,0.0,8.0,5,163,106,269,0.509469697
1063003,107,9,225,303,528,7,0,0.0,9.0,6,180,204,384,0.727272727
1063003,107,9,225,303,528,7,0,0.0,10.0,8,232,202,434,0.821969697
1063004,112,9,180,288,468,6,0,0.0,4.0,2,38,154,192,0.41025641
1063004,112,13,260,416,676,10,1,0.0,4.6,9,155,385,540,0.798816568
1063004,112,13,260,416,676,10,1,0.0,5.6,13,133,514,647,0.957100592
1063004,112,13,260,416,676,10,1,0.0,6.6,10,83,534,617,0.912721893
1063004,112,13,260,416,676,10,1,0.0,7.6,10,-43,554,511,0.75591716
1063004,112,13,260,416,676,10,1,0.0,8.6,1,18,74,92,0.136094675
1063005,111,6,135,201,336,4,0,0.0,0.0,3,176,16,192,0.571428571
1063005,111,6,135,201,336,4,0,0.0,1.0,2,136,44,180,0.535714286
1065001,112,13,260,416,676,10,1,0.0,0.0,12,-293,824,531,0.785502959
1065002,112,13,260,416,676,10,1,0.0,0.0,13,-233,877,644,0.952662722
1065003,112,13,260,416,676,10,1,0.0,0.0,14,145,521,666,0.985207101
1065004,112,13,260,416,676,10,1,0.0,0.0,13,1,636,637,0.942307692
1065005,112,13,260,416,676,10,1,0.0,0.0,14,134,527,661,0.977810651
1065006,112,13,260,416,676,10,1,0.0,0.0,12,83,542,625,0.924556213
1065007,112,13,260,416,676,10,1,0.0,0.0,14,233,439,672,0.99408284
1065008,112,13,260,416,676,10,1,0.4,0.1,14,316,335,651,0.963017751
1065009,112,13,260,416,676,10,1,0.0,0.0,14,137,520,657,0.971893491
1067001,78,13,312,156,468,10,0,4.3,5.1,13,80,380,460,0.982905983
1067001,78,13,312,156,468,10,0,4.3,6.1,12,199,227,426,0.91025641
1067002,78,13,312,156,468,10,0,4.4,3.6,13,41,417,458,0.978632479
1067002,78,13,312,156,468,10,0,4.4,4.6,13,119,325,444,0.948717949
1069001,112,13,260,416,676,10,1,0.0,0.0,10,263,293,556,0.822485207
1069002,112,13,260,416,676,10,1,0.0,0.0,8,265,206,471,0.696745562
1069003,112,13,260,416,676,10,1,0.0,0.0,7,241,192,433,0.640532544
1069004,112,13,260,416,676,10,1,0.0,0.0,7,115,341,456,0.674556213
1069005,112,13,260,416,676,10,1,0.0,0.0,4,121,187,308,0.455621302
1069006,108,12,270,366,636,9,0,0.0,0.0,3,197,34,231,0.363207547
1070001,129,154,9477,9411,18888,61,0,0.0,5.0819674,168,5749,7945,13694,0.725010589
1072001,110,21,458,573,1031,14,0,0.0,7.785714,17,205,695,900,0.872938894
1072002,104,12,334,390,724,9,0,0.0,6.5555553,11,545,167,712,0.983425414
1073001,112,13,260,416,676,10,1,0.0,0.0,13,189,459,648,0.958579882
1073001,112,13,260,416,676,10,1,0.0,1.0,11,-356,888,532,0.786982249
1073001,112,13,260,416,676,10,1,0.0,2.0,9,238,273,511,0.75591716
1073002,112,13,260,416,676,10,1,0.0,0.0,13,277,399,676,1.0
1073002,112,13,260,416,676,10,1,0.0,1.0,13,167,487,654,0.967455621
1073002,112,13,260,416,676,10,1,0.0,2.0,11,241,335,576,0.852071006
1073003,112,13,260,416,676,10,1,0.0,0.0,11,153,434,587,0.868343195
1073003,112,13,260,416,676,10,1,0.0,1.0,11,157,377,534,0.789940828
1073003,112,13,260,416,676,10,1,0.0,2.0,10,288,196,484,0.715976331
1074001,65,13,780,390,1170,10,0,0.0,6.2,11,105,920,1025,0.876068376
1074001,65,13,780,390,1170,10,0,0.0,7.2,8,15,795,810,0.692307692
1074002,65,13,780,390,1170,10,0,0.2,6.7,11,431,649,1080,0.923076923
1074002,65,13,780,390,1170,10,0,0.2,7.7,8,305,680,985,0.841880342
1074003,65,13,780,390,1170,10,0,0.2,6.3,7,281,654,935,0.799145299
1074003,65,13,780,390,1170,10,0,0.2,7.3,7,250,695,945,0.807692308
1075001,108,9,198,270,468,21,0,0.0,1.0,2,71,91,162,0.346153846
1076001,125,24,303,606,909,18,0,0.0,4.0,26,729,73,802,0.882288229
1078001,65,13,780,390,1170,10,0,0.7,2.1,8,-113,1053,940,0.803418803
1078001,65,13,780,390,1170,10,0,0.7,3.1,3,242,128,370,0.316239316
1078002,65,13,780,390,1170,10,0,0.7,2.1,8,-418,1268,850,0.726495726
1078002,65,13,780,390,1170,10,0,0.7,3.1,7,-445,1245,800,0.683760684
1078003,65,13,780,390,1170,10,0,0.7,2.6,9,322,683,1005,0.858974359
1078003,65,13,780,390,1170,10,0,0.7,3.6,1,72,83,155,0.132478632
1078004,65,13,780,390,1170,10,0,0.3,2.8,9,234,836,1070,0.914529915
1078004,65,13,780,390,1170,10,0,0.3,3.8,4,224,376,600,0.512820513
1079001,112,13,260,416,676,10,1,0.0,1.3,11,104,475,579,0.856508876
1079002,107,9,225,303,528,7,0,0.0,1.0,8,132,319,451,0.854166667
1080001,78,13,312,156,468,10,0,1.4,7.3,14,266,184,450,0.961538462
1080001,78,13,312,156,468,10,0,1.4,8.3,6,-232,404,172,0.367521368
1080002,78,13,312,156,468,10,0,0.9,7.3,12,-16,458,442,0.944444444
1080002,78,13,312,156,468,10,0,0.9,8.3,5,68,220,288,0.615384615
1080003,78,13,312,156,468,10,0,1.8,5.4,10,-142,540,398,0.85042735
1080003,78,13,312,156,468,10,0,1.8,6.4,4,46,142,188,0.401709402
1080004,79,6,150,84,234,4,0,1.0,5.0,2,-9,123,114,0.487179487
1082001,103,8,208,228,436,19,0,0.0,3.0526316,8,140,272,412,0.944954128
1082001,103,8,208,228,436,19,0,0.0,4.0526314,8,247,147,394,0.903669725
1082001,103,8,208,228,436,19,0,0.0,5.0526314,7,201,134,335,0.768348624
1083001,116,17,306,578,884,12,0,0.0,2.5,15,22,818,840,0.950226244
1083002,116,17,306,578,884,12,0,0.0,2.0,13,452,292,744,0.841628959
1083003,116,17,306,578,884,12,0,0.0,2.5,13,509,209,718,0.812217195
1084001,104,55,1459,1485,2944,40,0,0.0,0.0,46,650,1866,2516,0.854619565
1084001,104,55,1459,1485,2944,40,0,0.0,1.0,54,1485,1331,2816,0.956521739
1084001,104,55,1459,1485,2944,40,0,0.0,2.0,55,1626,1224,2850,0.968070652
1084001,104,55,1459,1485,2944,40,0,0.0,3.0,54,1687,1141,2828,0.960597826
1084001,104,55,1459,1485,2944,40,0,0.0,4.0,54,1750,1086,2836,0.963315217
1084002,104,55,1459,1485,2944,40,0,0.0,0.0,46,732,1818,2550,0.866168478
1084002,104,55,1459,1485,2944,40,0,0.0,1.0,56,986,1894,2880,0.97826087
1084002,104,55,1459,1485,2944,40,0,0.0,2.0,59,1565,1352,2917,0.990828804
1084002,104,55,1459,1485,2944,40,0,0.0,3.0,54,1955,913,2868,0.974184783
1084002,104,55,1459,1485,2944,40,0,0.0,4.0,56,1683,1202,2885,0.979959239
1084003,104,55,1459,1485,2944,40,0,0.0,0.0,42,617,1880,2497,0.848165761
1084003,104,55,1459,1485,2944,40,0,0.0,1.0,55,1135,1685,2820,0.957880435
1084003,104,55,1459,1485,2944,40,0,0.0,2.0,56,1372,1507,2879,0.977921196
1084003,104,55,1459,1485,2944,40,0,0.0,3.0,53,1548,1155,2703,0.918138587
1084003,104,55,1459,1485,2944,40,0,0.0,4.0,55,1580,1224,2804,0.952445652
1084004,104,55,1459,1485,2944,40,0,0.0,0.0,46,1240,1423,2663,0.90455163
1084004,104,55,1459,1485,2944,40,0,0.0,1.0,52,1424,1407,2831,0.961616848
1084004,104,55,1459,1485,2944,40,0,0.0,2.0,52,1487,1270,2757,0.936480978
1084004,104,55,1459,1485,2944,40,0,0.0,3.0,53,1499,1366,2865,0.973165761
1084004,104,55,1459,1485,2944,40,0,0.0,4.0,50,1455,1333,2788,0.94701087
1084005,104,55,1459,1485,2944,40,0,0.0,0.0,54,468,2359,2827,0.960258152
1084005,104,55,1459,1485,2944,40,0,0.0,1.0,50,840,1948,2788,0.94701087
1084005,104,55,1459,1485,2944,40,0,0.0,2.0,52,1056,1663,2719,0.92357337
1084005,104,55,1459,1485,2944,40,0,0.0,3.0,52,1584,1192,2776,0.942934783
1084005,104,55,1459,1485,2944,40,0,0.0,4.0,52,1925,874,2799,0.950747283
1084006,100,39,1038,993,2031,27,0,0.0,0.0,30,740,951,1691,0.832594781
1084006,100,39,1038,993,2031,27,0,0.0,1.0,32,898,835,1733,0.853274249
1084006,100,39,1038,993,2031,27,0,0.0,2.0,36,1135,758,1893,0.932053176
1084006,100,39,1038,993,2031,27,0,0.0,3.0,34,1112,686,1798,0.885278188
1084006,100,39,1038,993,2031,27,0,0.0,4.0,31,1072,662,1734,0.853766617
1086001,100,26,650,650,1300,60,0,0.06666667,3.9333334,11,287,331,618,0.475384615
1086001,100,26,650,650,1300,60,0,0.06666667,4.9333334,23,212,870,1082,0.832307692
1086001,100,26,650,650,1300,60,0,0.06666667,5.9333334,25,497,683,1180,0.907692308
1086002,100,3,144,144,288,6,0,0.0,4.0,1,50,46,96,0.333333333
1086002,100,3,144,144,288,6,0,0.0,5.0,3,107,181,288,1.0
1087001,105,2,65,75,140,6,0,1.0,9.0,2,40,100,140,1.0
1087001,105,2,65,75,140,6,0,1.0,10.0,3,11,109,120,0.857142857
1087001,105,2,65,75,140,6,0,1.0,11.0,3,19,101,120,0.857142857
1087002,105,2,65,75,140,6,0,0.5,8.333333,2,46,94,140,1.0
1087002,105,2,65,75,140,6,0,0.5,9.333333,1,150,-50,100,0.714285714
1087002,105,2,65,75,140,6,0,0.5,10.333333,3,68,52,120,0.857142857
1087003,105,2,65,75,140,6,0,0.33333334,8.666667,2,-3,58,55,0.392857143
1087003,105,2,65,75,140,6,0,0.33333334,9.666667,1,13,62,75,0.535714286
1087003,105,2,65,75,140,6,0,0.33333334,10.666667,1,50,50,100,0.714285714
1087004,105,2,65,75,140,6,0,1.3333334,7.5,1,20,80,100,0.714285714
1087004,105,2,65,75,140,6,0,1.3333334,8.5,2,39,101,140,1.0
1087004,105,2,65,75,140,6,0,1.3333334,9.5,3,75,45,120,0.857142857
1087005,105,2,65,75,140,6,0,0.0,10.0,2,23,82,105,0.75
1087006,105,2,65,75,140,6,0,0.0,9.333333,1,52,48,100,0.714285714
1087006,105,2,65,75,140,6,0,0.0,10.333333,2,48,92,140,1.0
1087006,105,2,65,75,140,6,0,0.0,11.333333,3,93,27,120,0.857142857
1087007,105,2,65,75,140,6,0,0.0,10.0,2,55,85,140,1.0
1087007,105,2,65,75,140,6,0,0.0,11.0,1,21,79,100,0.714285714
1087007,105,2,65,75,140,6,0,0.0,12.0,2,56,84,140,1.0
1087008,105,2,65,75,140,6,0,0.5,8.5,3,55,65,120,0.857142857
1087008,105,2,65,75,140,6,0,0.5,9.5,2,43,72,115,0.821428571
1087008,105,2,65,75,140,6,0,0.5,10.5,2,69,71,140,1.0
1087009,105,2,65,75,140,6,0,0.5,9.5,1,27,3,30,0.214285714
1087009,105,2,65,75,140,6,0,0.5,10.5,3,68,52,120,0.857142857
1087009,105,2,65,75,140,6,0,0.5,11.5,1,51,49,100,0.714285714
1088001,112,13,260,416,676,10,1,0.0,2.0,15,-225,885,660,0.976331361
1088001,112,13,260,416,676,10,1,0.0,3.0,12,8,599,607,0.897928994
1088001,112,13,260,416,676,10,1,0.0,4.0,12,111,511,622,0.920118343
1088002,112,13,260,416,676,10,1,0.2,1.6,10,351,152,503,0.74408284
1088002,112,13,260,416,676,10,1,0.2,2.6,10,34,527,561,0.829881657
1088002,112,13,260,416,676,10,1,0.2,3.6,9,296,145,441,0.652366864
1088003,112,13,260,416,676,10,1,1.1,1.2,11,81,496,577,0.853550296
1088003,112,13,260,416,676,10,1,1.1,2.2,12,258,348,606,0.896449704
1088003,112,13,260,416,676,10,1,1.1,3.2,13,133,505,638,0.943786982
1088004,112,13,260,416,676,10,1,0.5,1.8,15,659,1,660,0.976331361
1088004,112,13,260,416,676,10,1,0.5,2.8,13,427,231,658,0.973372781
1088004,112,13,260,416,676,10,1,0.5,3.8,12,475,128,603,0.892011834
1088005,112,13,260,416,676,10,1,0.5,1.4,14,466,203,669,0.98964497
1088005,112,13,260,416,676,10,1,0.5,2.4,15,352,308,660,0.976331361
1088005,112,13,260,416,676,10,1,0.5,3.4,13,429,223,652,0.964497041
1088006,112,13,260,416,676,10,1,0.3,1.8,12,-163,766,603,0.892011834
1088006,112,13,260,416,676,10,1,0.3,2.8,14,-212,863,651,0.963017751
1088006,112,13,260,416,676,10,1,0.3,3.8,14,227,422,649,0.960059172
1088007,112,13,260,416,676,10,1,0.8,1.2,11,348,174,522,0.772189349
1088007,112,13,260,416,676,10,1,0.8,2.2,15,-118,778,660,0.976331361
1088007,112,13,260,416,676,10,1,0.8,3.2,13,175,492,667,0.986686391
1088009,112,13,260,416,676,10,1,1.1,1.2,12,146,469,615,0.909763314
1088009,112,13,260,416,676,10,1,1.1,2.2,13,149,482,631,0.933431953
1088009,112,13,260,416,676,10,1,1.1,3.2,14,161,497,658,0.973372781
1089001,112,20,510,740,1250,10,0,1.4,1.3,17,580,562,1142,0.9136
1089001,112,20,510,740,1250,10,0,1.4,2.3,17,555,589,1144,0.9152
1090001,112,13,260,416,676,10,1,0.1,2.9,9,156,426,582,0.860946746
1090001,112,13,260,416,676,10,1,0.1,3.9,15,284,376,660,0.976331361
1090002,112,13,260,416,676,10,1,0.0,3.0,10,230,354,584,0.863905325
1090002,112,13,260,416,676,10,1,0.0,4.0,11,264,340,604,0.893491124
1090003,112,13,260,416,676,10,1,0.3,2.7,12,175,451,626,0.926035503
1090003,112,13,260,416,676,10,1,0.3,3.7,10,210,390,600,0.887573964
1090004,112,13,260,416,676,10,1,0.3,2.7,12,296,353,649,0.960059172
1090004,112,13,260,416,676,10,1,0.3,3.7,13,289,369,658,0.973372781
1091001,110,21,420,630,1050,16,0,0.0,0.0,21,937,72,1009,0.960952381
1091002,110,21,420,630,1050,16,0,0.0,0.0,21,494,501,995,0.947619048
1092001,107,3,81,102,183,4,0,0.0,2.0,3,144,16,160,0.87431694
1092002,107,3,81,102,183,4,0,0.0,2.0,2,188,-96,92,0.50273224
1092003,107,3,81,102,183,4,0,0.0,1.75,3,94,89,183,1.0
1092004,107,3,81,102,183,4,0,0.0,2.0,2,71,-27,44,0.240437158
1092005,107,3,81,102,183,4,0,0.0,2.0,1,20,80,100,0.546448087
1093001,76,34,1266,1302,2568,36,0,0.0,0.0,40,1455,449,1904,0.741433022
1094001,112,13,260,416,676,10,1,0.0,1.0,11,324,217,541,0.800295858
1096001,83,34,1156,561,1717,35,0,0.0,0.0,28,552,839,1391,0.810133955
1098001,112,13,260,416,676,10,1,0.2,2.8,14,36,619,655,0.968934911
1098002,112,13,260,416,676,10,1,0.1,2.9,15,202,458,660,0.976331361
1098003,112,13,260,416,676,10,1,0.1,2.9,14,119,527,646,0.955621302
1098004,112,13,260,416,676,10,1,0.0,3.0,12,208,383,591,0.874260355
1098005,112,13,260,416,676,10,1,0.1,2.9,13,632,-20,612,0.905325444
1098006,112,13,260,416,676,10,1,0.2,2.8,14,448,216,664,0.982248521
1098007,112,13,260,416,676,10,1,0.3,2.7,11,182,424,606,0.896449704
1098008,112,13,260,416,676,10,1,0.2,2.8,14,-835,1498,663,0.980769231
1099001,112,13,260,416,676,10,1,0.0,0.0,10,29,605,634,0.937869822
1099001,112,13,260,416,676,10,1,0.0,1.0,10,176,451,627,0.927514793
1099001,112,13,260,416,676,10,1,0.0,2.0,5,67,296,363,0.536982249
1099002,112,13,260,416,676,10,1,0.0,0.0,9,114,435,549,0.812130178
1099002,112,13,260,416,676,10,1,0.0,1.0,7,66,431,497,0.735207101
1099002,112,13,260,416,676,10,1,0.0,2.0,3,27,220,247,0.365384615
1099003,112,13,260,416,676,10,1,0.0,0.0,12,318,325,643,0.951183432
1099003,112,13,260,416,676,10,1,0.0,1.0,10,162,430,592,0.875739645
1099003,112,13,260,416,676,10,1,0.0,2.0,7,35,396,431,0.637573964
1105001,95,10,135,225,360,10,0,0.0,2.0,12,253,57,310,0.861111111
1105002,95,10,135,225,360,10,0,0.0,1.0,10,339,-44,295,0.819444444
1105003,95,10,135,225,360,10,0,0.0,1.0,11,228,82,310,0.861111111
1105004,95,10,135,225,360,10,0,0.0,1.0,9,151,140,291,0.808333333
1107001,105,12,276,330,606,9,0,0.0,6.0,7,145,249,394,0.650165017
1107001,105,12,276,330,606,9,0,0.0,7.0,11,271,330,601,0.991749175
1107001,105,12,276,330,606,9,0,0.0,8.0,10,395,187,582,0.96039604
1108001,106,54,1310,1814,3124,26,0,0.0,0.0,55,2019,787,2806,0.898207426
1110001,600,3,750,750,1500,10,0,0.0,5.8,5,1447,-447,1000,0.666666667
1111001,45,9,171,171,342,8,0,0.0,0.0,10,165,171,336,0.98245614
1112001,101,23,828,841,1669,24,0,0.0,0.0,21,469,881,1350,0.808867585
1112001,101,23,828,841,1669,24,0,0.0,1.0,25,550,988,1538,0.921509886
1112001,101,23,828,841,1669,24,0,0.0,2.0,21,454,1001,1455,0.871779509
1112001,101,23,828,841,1669,24,0,0.0,3.0,22,752,888,1640,0.982624326
1112001,101,23,828,841,1669,24,0,0.0,4.0,25,659,951,1610,0.964649491
1112001,101,23,828,841,1669,24,0,0.0,5.0,24,675,933,1608,0.963451168
1113001,100,16,240,240,480,20,0,0.0,0.0,18,187,113,300,0.625
1113001,100,16,240,240,480,20,0,0.0,1.0,19,223,183,406,0.845833333
1113001,100,16,240,240,480,20,0,0.0,2.0,18,180,182,362,0.754166667
1113001,100,16,240,240,480,20,0,0.0,3.0,12,204,186,390,0.8125
1113002,100,16,240,240,480,20,0,0.0,0.0,18,-474,750,276,0.575
1113002,100,16,240,240,480,20,0,0.0,1.0,20,295,31,326,0.679166667
1113002,100,16,240,240,480,20,0,0.0,2.0,16,190,156,346,0.720833333
1113002,100,16,240,240,480,20,0,0.0,3.0,14,192,148,340,0.708333333
1113003,100,16,240,240,480,20,0,0.0,0.55,24,150,12,162,0.3375
1113003,100,16,240,240,480,20,0,0.0,1.55,19,-273,531,258,0.5375
1113003,100,16,240,240,480,20,0,0.0,2.55,20,-381,639,258,0.5375
1113003,100,16,240,240,480,20,0,0.0,3.55,23,-226,440,214,0.445833333
1113004,100,16,240,240,480,20,0,0.0,0.0,20,104,202,306,0.6375
1113004,100,16,240,240,480,20,0,0.0,1.0,19,268,86,354,0.7375
1113004,100,16,240,240,480,20,0,0.0,2.0,15,220,132,352,0.733333333
1113004,100,16,240,240,480,20,0,0.0,3.0,20,164,186,350,0.729166667
1113005,100,16,240,240,480,20,0,0.0,0.2,17,204,152,356,0.741666667
1113005,100,16,240,240,480,20,0,0.0,1.2,20,74,222,296,0.616666667
1113005,100,16,240,240,480,20,0,0.0,2.2,20,189,169,358,0.745833333
1113005,100,16,240,240,480,20,0,0.0,3.2,12,9,315,324,0.675
1113006,100,16,240,240,480,20,0,0.0,0.15,16,1,383,384,0.8
1113006,100,16,240,240,480,20,0,0.0,1.15,18,55,327,382,0.795833333
1113006,100,16,240,240,480,20,0,0.0,2.15,18,140,274,414,0.8625
1113006,100,16,240,240,480,20,0,0.0,3.15,17,179,275,454,0.945833333
1113007,100,16,240,240,480,20,0,0.0,0.0,20,-267,581,314,0.654166667
1113007,100,16,240,240,480,20,0,0.0,1.0,16,13,309,322,0.670833333
1113007,100,16,240,240,480,20,0,0.0,2.0,20,106,186,292,0.608333333
1113007,100,16,240,240,480,20,0,0.0,3.0,16,54,276,330,0.6875
1113008,100,16,240,240,480,20,0,0.0,0.0,22,-53,275,222,0.4625
1113008,100,16,240,240,480,20,0,0.0,1.0,18,19,343,362,0.754166667
1113008,100,16,240,240,480,20,0,0.0,2.0,18,157,149,306,0.6375
1113008,100,16,240,240,480,20,0,0.0,3.0,13,130,88,218,0.454166667
1113009,100,16,240,240,480,20,0,0.0,0.0,17,29,331,360,0.75
1113009,100,16,240,240,480,20,0,0.0,1.0,19,275,15,290,0.604166667
1113009,100,16,240,240,480,20,0,0.0,2.0,20,112,234,346,0.720833333
1113009,100,16,240,240,480,20,0,0.0,3.0,14,219,161,380,0.791666667
1113010,100,16,240,240,480,20,0,0.0,0.0,16,258,96,354,0.7375
1113010,100,16,240,240,480,20,0,0.0,1.0,20,-7,257,250,0.520833333
1113010,100,16,240,240,480,20,0,0.0,2.0,17,-99,357,258,0.5375
1113010,100,16,240,240,480,20,0,0.0,3.0,12,-262,474,212,0.441666667
1113011,100,16,240,240,480,20,0,0.0,0.2,19,-640,950,310,0.645833333
1113011,100,16,240,240,480,20,0,0.0,1.2,17,-9,225,216,0.45
1113011,100,16,240,240,480,20,0,0.0,2.2,17,-431,697,266,0.554166667
1113011,100,16,240,240,480,20,0,0.0,3.2,13,149,151,300,0.625
1113012,100,16,240,240,480,20,0,0.0,0.3,21,-454,694,240,0.5
1113012,100,16,240,240,480,20,0,0.0,1.3,23,-1129,1311,182,0.379166667
1113012,100,16,240,240,480,20,0,0.0,2.3,13,-414,580,166,0.345833333
1113012,100,16,240,240,480,20,0,0.0,3.3,8,-225,387,162,0.3375
1113016,100,2,40,40,80,2,0,0.0,0.0,1,29,31,60,0.75
1114001,112,13,260,416,676,10,1,0.0,2.0,12,181,461,642,0.949704142
1114002,112,13,260,416,676,10,1,0.0,2.0,13,477,174,651,0.963017751
1114003,112,13,260,416,676,10,1,0.0,2.0,11,-145,727,582,0.860946746
1114004,112,13,260,416,676,10,1,0.0,2.0,10,166,371,537,0.794378698
1114005,112,13,260,416,676,10,1,0.0,2.0,7,272,100,372,0.550295858
1114006,112,13,260,416,676,10,1,0.0,2.0,11,94,514,608,0.899408284
1114007,112,13,260,416,676,10,1,0.0,2.0,10,314,305,619,0.915680473
1114008,112,13,260,416,676,10,1,0.0,2.0,9,-79,544,465,0.687869822
1114009,112,13,260,416,676,10,1,0.0,2.0,7,103,243,346,0.51183432
1114010,112,13,260,416,676,10,1,0.0,1.9,9,143,400,543,0.803254438
1114011,112,13,260,416,676,10,1,0.0,2.0,12,163,491,654,0.967455621
1114012,112,13,260,416,676,10,1,0.0,2.0,11,77,517,594,0.878698225
1114013,111,6,135,201,336,4,0,0.0,2.0,2,85,75,160,0.476190476
1118001,100,15,495,495,990,10,0,0.0,0.1,3,57,237,294,0.296969697
1118001,100,15,495,495,990,10,0,0.0,1.1,4,178,149,327,0.33030303
1119001,215,5,675,625,1300,13,0,0.0,0.23076923,5,794,506,1300,1.0
1121001,95,10,135,225,360,10,0,0.2,1.8,7,45,265,310,0.861111111
1121002,95,10,135,225,360,10,0,0.6,1.4,9,144,194,338,0.938888889
1121003,95,10,135,225,360,10,0,0.1,1.9,9,122,220,342,0.95
1121004,95,10,135,225,360,10,0,1.0,2.2,10,188,110,298,0.827777778
1122001,96,10,155,235,390,10,0,0.3,2.7,11,98,207,305,0.782051282
1122001,96,10,155,235,390,10,0,0.3,3.7,9,178,135,313,0.802564103
1122002,96,10,155,235,390,10,0,0.0,3.0,10,156,214,370,0.948717949
1122002,96,10,155,235,390,10,0,0.0,4.0,9,140,159,299,0.766666667
1122003,96,10,155,235,390,10,0,0.1,2.9,12,96,249,345,0.884615385
1122003,96,10,155,235,390,10,0,0.1,3.9,12,161,188,349,0.894871795
1122004,96,10,155,235,390,10,0,0.4,2.6,11,127,214,341,0.874358974
1122004,96,10,155,235,390,10,0,0.4,3.6,10,71,203,274,0.702564103
1126001,113,13,585,429,1014,10,0,0.0,1.4,15,-68,1058,990,0.976331361
1127001,90,16,440,440,880,32,0,0.0,0.0,15,296,535,831,0.944318182
1127001,90,16,440,440,880,32,0,0.0,1.0,16,446,434,880,1.0
1127001,90,16,440,440,880,32,0,0.0,2.0,15,426,390,816,0.927272727
1127001,90,16,440,440,880,32,0,0.0,3.0,15,476,391,867,0.985227273
1127001,90,16,440,440,880,32,0,0.0,4.0,15,518,328,846,0.961363636
1131001,109,186,4469,5572,10041,147,0,0.0,0.0,143,6618,668,7286,0.725624938
1131001,109,188,4532,5572,10104,148,0,0.0,0.9932432,148,5492,2079,7571,0.749307205
1131001,109,188,4532,5572,10104,148,0,0.0,1.9932432,150,4837,2668,7534,0.745645289
1131001,109,188,4532,5572,10104,148,0,0.0,2.9932432,155,4835,2882,7717,0.763756928
1132001,120,16,640,640,1280,32,0,0.0,2.03125,15,725,511,1236,0.965625
1133001,104,55,1450,1485,2935,40,0,0.0,1.9,48,1718,796,2514,0.856558773
1133002,104,55,1450,1485,2935,40,0,0.0,2.15,52,2473,275,2748,0.936286201
1133003,104,55,1450,1485,2935,40,0,0.0,1.9,48,2012,704,2716,0.925383305
1133004,104,55,1450,1485,2935,40,0,0.0,2.0,51,1916,795,2711,0.923679727
1133005,104,55,1450,1485,2935,40,0,0.0,2.0,52,886,1855,2741,0.933901193
1133006,99,36,968,903,1871,25,0,0.0,1.76,20,156,1050,1206,0.644575094
1135001,129,146,8977,8935,17912,57,0,0.0,6.4385967,151,8805,4635,13440,0.750334971
1136001,112,13,260,416,676,10,1,0.0,0.0,10,273,331,604,0.893491124
1136001,112,13,260,416,676,10,1,0.0,1.0,10,283,311,594,0.878698225
1136002,112,13,260,416,676,10,1,0.0,0.0,10,-42,604,562,0.831360947
1136002,112,13,260,416,676,10,1,0.0,1.0,11,-7,603,596,0.881656805
1136003,112,13,260,416,676,10,1,0.0,0.0,8,283,176,459,0.678994083
1136003,112,13,260,416,676,10,1,0.0,1.0,9,279,222,501,0.74112426
1136004,112,13,260,416,676,10,1,0.0,0.0,10,-308,842,534,0.789940828
1136004,112,13,260,416,676,10,1,0.0,1.0,9,257,281,538,0.795857988
1136005,112,13,260,416,676,10,1,0.0,0.0,12,133,528,661,0.977810651
1136005,112,13,260,416,676,10,1,0.0,1.0,9,141,398,539,0.797337278
1136006,112,13,260,416,676,10,1,0.0,0.0,10,245,301,546,0.807692308
1136006,112,13,260,416,676,10,1,0.0,1.0,10,298,258,556,0.822485207
1136007,112,13,260,416,676,10,1,0.0,0.9,10,46,518,564,0.834319527
1136007,112,13,260,416,676,10,1,0.0,1.9,11,155,446,601,0.889053254
1137001,500,18,4716,4716,9432,24,0,0.0,6.0416665,19,4599,3565,8164,0.865564037
1139001,83,34,1156,561,1717,31,0,0.83870965,3.7741935,30,838,722,1560,0.908561444
1139001,83,34,1156,561,1717,31,0,0.83870965,4.774194,28,690,706,1396,0.81304601
1140001,102,51,1413,1332,2745,37,0,2.945946,3.4324324,37,1199,1150,2349,0.855737705
1142001,107,15,330,435,765,11,0,0.0,2.909091,12,454,234,688,0.899346405
1142002,107,15,330,435,765,11,0,0.0,2.7272727,12,319,346,665,0.869281046
1143001,108,234,4857,6897,11754,184,0,0.0,0.90217394,193,2691,6695,9386,0.798536668
1144001,112,13,260,416,676,10,1,0.0,2.0,12,541,90,631,0.933431953
1144002,112,13,260,416,676,10,1,0.0,2.0,13,276,385,661,0.977810651
1144003,112,13,260,416,676,10,1,0.0,2.0,12,186,407,593,0.877218935
1144004,112,13,260,416,676,10,1,0.0,2.0,14,297,370,667,0.986686391
1144005,112,13,260,416,676,10,1,0.0,2.0,14,737,-73,664,0.982248521
1144006,112,13,260,416,676,10,1,0.0,2.0,13,377,277,654,0.967455621
1144007,112,13,260,416,676,10,1,0.0,2.0,13,396,280,676,1.0
1144008,112,13,260,416,676,10,1,0.0,2.0,10,324,205,529,0.782544379
1144009,112,13,260,416,676,10,1,0.0,2.0,15,246,414,660,0.976331361
1144010,112,13,260,416,676,10,1,0.0,2.0,8,294,204,498,0.736686391
1144011,112,13,260,416,676,10,1,0.0,2.0,13,462,192,654,0.967455621
1144012,112,13,260,416,676,10,1,0.0,2.0,13,497,170,667,0.986686391
1144013,112,13,260,416,676,10,1,0.0,2.0,12,362,249,611,0.903846154
1144014,112,13,260,416,676,10,1,0.0,2.0,11,209,445,654,0.967455621
1144015,112,13,260,416,676,10,1,0.0,2.0,12,316,334,650,0.961538462
1144016,112,13,260,416,676,10,1,0.0,2.0,12,352,276,628,0.928994083
1144017,112,13,260,416,676,10,1,0.0,2.0,12,284,280,564,0.834319527
1144018,112,13,260,416,676,10,1,0.0,2.0,10,244,301,545,0.806213018
1144019,112,13,260,416,676,10,1,0.0,1.0,10,444,77,521,0.770710059
1144020,112,9,180,288,468,6,0,0.0,0.6666667,1,3,86,89,0.19017094
1146001,112,13,260,416,676,10,1,0.0,0.0,13,139,471,610,0.902366864
1146002,112,13,260,416,676,10,1,0.0,0.0,10,109,493,602,0.890532544
1146003,112,13,260,416,676,10,1,0.0,0.0,11,88,498,586,0.866863905
1147001,57,6,63,102,165,10,0,0.0,2.0,2,-58,80,22,0.133333333
1147002,57,6,63,102,165,10,0,0.0,2.0,7,-163,267,104,0.63030303
1147003,56,4,40,76,116,5,0,0.0,2.0,5,-17,114,97,0.836206897
1148001,76,34,2285,1256,3541,12,0,0.0,1.6666666,12,830,852,1682,0.47500706
1148001,90,40,2231,1669,3900,15,0,0.0,2.5333333,8,400,663,1063,0.272564103
1148001,113,46,1764,2401,4165,18,0,0.0,3.1666667,15,217,1406,1623,0.38967587
1148001,90,45,2303,2087,4390,21,0,0.0,3.8095238,6,192,585,777,0.176993166
1150001,89,2,77,55,132,5,0,0.0,0.0,2,130,2,132,1.0
1152001,97,67,1122,1850,2972,60,0,0.0,0.16666667,54,130,2071,2201,0.740578735
1152001,97,67,1122,1850,2972,60,0,0.0,1.1666666,63,487,1854,2341,0.787685061
1152001,97,67,1122,1850,2972,60,0,0.0,2.1666667,70,311,2156,2467,0.830080754
1152001,97,67,1122,1850,2972,60,0,0.0,3.1666667,69,-186,2592,2406,0.809555855
1152002,97,67,1122,1850,2972,60,0,0.0,0.016666668,60,866,1516,2382,0.801480485
1152002,97,67,1122,1850,2972,60,0,0.0,1.0166667,67,1035,1447,2482,0.83512786
1152002,97,67,1122,1850,2972,60,0,0.0,2.0166667,71,1090,1523,2613,0.879205922
1152002,97,67,1122,1850,2972,60,0,0.0,3.0166667,65,1052,1578,2630,0.884925976
1152003,97,67,1122,1850,2972,60,0,0.0,0.0,50,520,1726,2246,0.755720054
1152003,97,67,1122,1850,2972,60,0,0.0,1.0,63,1520,1091,2611,0.878532974
1152003,97,67,1122,1850,2972,60,0,0.0,2.0,60,893,1519,2412,0.811574697
1152003,97,67,1122,1850,2972,60,0,0.0,3.0,53,885,1328,2213,0.74461642
1152004,95,34,719,864,1583,30,0,0.0,0.13333334,20,40,748,788,0.497789008
1152004,95,37,751,935,1686,32,0,0.0,1.0625,38,1210,157,1367,0.810794781
1152004,94,38,789,966,1755,33,0,0.0,2.1818182,33,-70,1301,1231,0.701424501
1152004,94,38,789,966,1755,33,0,0.0,3.1818182,27,820,442,1262,0.719088319
1154001,122,15,210,315,525,15,0,0.0,0.46666667,19,438,-17,421,0.801904762
1154002,122,15,210,315,525,15,0,0.0,0.26666668,19,178,240,418,0.796190476
1154003,122,15,210,315,525,15,0,0.0,0.53333336,16,495,-90,405,0.771428571
1160001,95,6,180,150,330,5,0,0.0,0.0,6,64,234,298,0.903030303
1163005,112,13,260,416,676,10,1,1.2,9.0,2,73,61,134,0.198224852
1163005,112,13,260,416,676,10,1,1.2,10.0,3,93,93,186,0.275147929
1163005,112,13,260,416,676,10,1,1.2,11.0,1,9,75,84,0.124260355
1163006,112,13,260,416,676,10,1,0.5,6.3,11,132,380,512,0.75739645
1163006,112,13,260,416,676,10,1,0.5,7.3,11,126,408,534,0.789940828
1163006,112,13,260,416,676,10,1,0.5,8.3,10,119,399,518,0.766272189
1163006,112,13,260,416,676,10,1,0.5,9.3,10,153,362,515,0.76183432
1163006,112,13,260,416,676,10,1,0.5,10.3,10,121,394,515,0.76183432
1163006,112,13,260,416,676,10,1,0.5,11.3,11,112,431,543,0.803254438
1163007,112,13,260,416,676,10,1,0.0,5.8,6,50,253,303,0.448224852
1163007,112,13,260,416,676,10,1,0.0,6.8,4,36,227,263,0.389053254
1163007,112,13,260,416,676,10,1,0.0,7.8,1,-32,100,68,0.100591716
1163007,112,13,260,416,676,10,1,0.0,8.8,1,6,71,77,0.113905325
1163007,112,13,260,416,676,10,1,0.0,9.8,1,-11,79,68,0.100591716
1166001,112,13,260,416,676,10,1,1.0,1.0,13,247,419,666,0.985207101
1166002,112,13,260,416,676,10,1,1.1,0.9,13,369,248,617,0.912721893
1166004,112,9,180,288,468,6,0,1.1666666,0.8333333,6,-123,504,381,0.814102564
1167001,45,18,324,324,648,16,0,0.0,1.0,26,379,97,476,0.734567901
1169001,660,9,2237,1215,3452,33,0,0.0,9.0,9,1925,1249,3174,0.919466976
1171001,65,28,784,784,1568,16,0,0.0,2.0,25,1065,409,1474,0.94005102
1172001,114,30,645,1050,1695,30,0,0.0,1.0,27,214,1359,1573,0.928023599
1172002,114,30,645,1050,1695,30,0,0.0,1.0,28,539,1019,1558,0.919174041
1172003,114,30,645,1050,1695,30,0,0.0,1.0,27,451,1128,1579,0.931563422
1172004,114,30,645,1050,1695,30,0,0.0,1.0,26,787,722,1509,0.890265487
1172005,114,30,645,1050,1695,30,0,0.0,1.0,25,978,517,1495,0.8820059
1172006,114,30,645,1050,1695,30,0,0.0,1.0,22,-383,1632,1249,0.736873156
1172007,114,28,616,1008,1624,28,0,0.0,1.0,23,842,571,1413,0.870073892
1173001,112,13,260,416,676,10,1,0.0,1.0,11,465,133,598,0.884615385
1173002,112,13,260,416,676,10,1,0.0,1.0,12,334,282,616,0.911242604
1173003,112,13,260,416,676,10,1,0.0,1.0,14,-117,784,667,0.986686391
1173004,112,13,260,416,676,10,1,0.0,1.0,13,333,311,644,0.952662722
1173005,112,13,260,416,676,10,1,0.0,1.0,14,29,632,661,0.977810651
1173006,112,13,260,416,676,10,1,0.0,1.0,12,165,417,582,0.860946746
1173007,112,13,260,416,676,10,1,0.0,1.0,15,302,358,660,0.976331361
1173008,112,13,260,416,676,10,1,0.0,1.0,12,221,369,590,0.872781065
1173009,112,13,260,416,676,10,1,0.0,1.0,10,376,168,544,0.804733728
1173010,112,13,260,416,676,10,1,0.0,1.0,14,233,427,660,0.976331361
1173011,112,13,260,416,676,10,1,0.0,1.0,14,197,463,660,0.976331361
1173012,108,12,270,366,636,9,0,0.0,0.8888889,12,131,485,616,0.968553459
1174001,108,9,198,270,468,10,0,0.5,10.1,6,149,250,399,0.852564103
1174001,108,9,198,270,468,10,0,0.5,11.1,6,109,291,400,0.854700855
1174002,108,9,198,270,468,10,0,0.5,9.1,6,93,289,382,0.816239316
1174002,108,9,198,270,468,10,0,0.5,10.1,7,263,93,356,0.760683761
1174003,108,9,198,270,468,10,0,0.5,11.5,8,97,314,411,0.878205128
1174003,108,9,198,270,468,10,0,0.5,12.5,5,111,210,321,0.685897436
1177001,110,11,220,330,550,8,0,0.0,0.0,7,96,328,424,0.770909091
1177001,110,11,220,330,550,8,0,0.0,1.0,11,64,462,526,0.956363636
1179001,65,13,780,390,1170,10,0,0.6,3.6,13,286,824,1110,0.948717949
1179002,65,13,780,390,1170,10,0,0.9,3.0,10,247,673,920,0.786324786
1179003,65,13,780,390,1170,10,0,0.9,3.2,13,43,1037,1080,0.923076923
1179004,65,13,780,390,1170,10,0,0.9,3.0,10,-26,1031,1005,0.858974359
1180001,107,8,176,232,408,6,0,0.0,0.0,9,358,38,396,0.970588235
1180002,107,8,176,232,408,6,0,0.0,0.0,9,-477,873,396,0.970588235
1180005,107,6,132,174,306,4,0,0.0,0.0,5,78,226,304,0.993464052
1182001,112,13,260,416,676,10,1,0.0,0.0,14,293,350,643,0.951183432
1182001,112,13,260,416,676,10,1,0.0,1.0,8,287,201,488,0.721893491
1183001,260,61,7320,7320,14640,20,0,0.0,1.5,64,7782,2150,9932,0.678415301
1183002,248,58,7368,6612,13980,19,0,0.0,1.4210526,51,6613,4767,11380,0.814020029
1184001,103,25,725,725,1450,10,0,0.0,3.0,25,855,595,1450,1.0
1184001,103,25,725,725,1450,10,0,0.0,4.0,23,474,940,1414,0.975172414
1184001,103,25,725,725,1450,10,0,0.0,5.0,25,557,893,1450,1.0
1187001,116,17,306,578,884,12,0,0.5833333,2.4166667,12,232,536,768,0.868778281
1187001,116,17,306,578,884,12,0,0.5833333,3.4166667,14,199,567,766,0.866515837
1187002,116,17,306,578,884,12,0,0.41666666,2.5833333,13,239,519,758,0.857466063
1187002,116,17,306,578,884,12,0,0.41666666,3.5833333,15,169,687,856,0.968325792
1188001,112,13,260,416,676,10,1,0.1,1.2,10,230,342,572,0.846153846
1188002,112,13,260,416,676,10,1,0.1,0.9,14,284,375,659,0.974852071
1188003,112,13,260,416,676,10,1,0.0,1.0,10,268,304,572,0.846153846
1188004,112,13,260,416,676,10,1,0.0,1.4,13,389,265,654,0.967455621
1188005,112,13,260,416,676,10,1,0.0,1.2,13,240,386,626,0.926035503
1188006,112,13,260,416,676,10,1,0.0,1.2,6,192,187,379,0.560650888
1188007,112,13,260,416,676,10,1,0.0,1.2,12,205,427,632,0.934911243
1188008,112,13,260,416,676,10,1,0.1,1.1,10,224,303,527,0.779585799
1188009,112,13,260,416,676,10,1,0.0,1.1,8,208,272,480,0.710059172
1188010,112,13,260,416,676,10,1,0.1,1.4,12,212,451,663,0.980769231
1188011,112,13,260,416,676,10,1,0.1,0.9,14,398,247,645,0.954142012
1188012,112,13,260,416,676,10,1,0.0,1.4,11,351,303,654,0.967455621
1188013,112,13,260,416,676,10,1,0.1,1.1,10,194,428,622,0.920118343
1188014,112,13,260,416,676,10,1,0.1,1.0,11,225,401,626,0.926035503
1188015,112,13,260,416,676,10,1,0.0,1.2,11,126,496,622,0.920118343
1189001,112,13,260,416,676,10,1,0.0,0.0,11,458,122,580,0.857988166
1189002,112,13,260,416,676,10,1,1.2,0.8,14,175,497,672,0.99408284
1190001,90,7,154,154,308,24,0,1.5416666,0.8333333,10,7,187,194,0.62987013
1190001,90,7,154,154,308,24,0,1.5416666,1.8333334,9,0,156,156,0.506493506
1190002,90,7,154,154,308,22,0,1.4545455,0.6363636,9,153,45,198,0.642857143
1190002,90,7,154,154,308,22,0,1.4545455,1.6363636,8,272,2,274,0.88961039
1193001,112,13,260,416,676,10,1,0.0,0.2,10,481,54,535,0.791420118
1193002,112,13,260,416,676,10,1,0.0,0.0,13,410,198,608,0.899408284
1194001,106,48,1253,1362,2615,26,0,0.0,0.0,22,273,1362,1635,0.625239006
1194001,106,48,1253,1362,2615,26,0,0.0,1.0,37,471,1850,2321,0.887571702
1194001,106,48,1253,1362,2615,26,0,0.0,2.0,36,641,1580,2221,0.849330784
1194001,106,48,1253,1362,2615,26,0,0.0,3.0,42,701,1730,2431,0.929636711
1194001,106,48,1253,1362,2615,26,0,0.0,4.0,43,654,1815,2469,0.94416826
1195001,112,13,260,416,676,10,1,0.0,0.0,12,180,487,667,0.986686391
1195001,112,13,260,416,676,10,1,0.0,1.0,12,178,407,585,0.865384615
1195002,112,13,260,416,676,10,1,0.0,0.0,12,219,359,578,0.855029586
1195002,112,13,260,416,676,10,1,0.0,1.0,13,259,400,659,0.974852071
1195003,112,13,260,416,676,10,1,0.0,0.0,11,216,428,644,0.952662722
1195003,112,13,260,416,676,10,1,0.0,1.0,13,457,214,671,0.99260355
1195004,112,13,260,416,676,10,1,0.0,0.0,12,241,422,663,0.980769231
1195004,112,13,260,416,676,10,1,0.0,1.0,12,191,476,667,0.986686391
1196001,112,13,260,416,676,10,1,0.0,0.0,11,-185,737,552,0.816568047
1196001,112,13,260,416,676,10,1,0.0,1.0,13,84,576,660,0.976331361
1196002,112,13,260,416,676,10,1,0.0,0.0,13,-85,671,586,0.866863905
1196002,112,13,260,416,676,10,1,0.0,1.0,11,-60,653,593,0.877218935
1196003,112,13,260,416,676,10,1,0.0,0.0,11,-258,867,609,0.900887574
1196003,112,13,260,416,676,10,1,0.0,1.0,11,-177,737,560,0.828402367
1196004,112,13,260,416,676,10,1,0.0,0.0,12,468,116,584,0.863905325
1196004,112,13,260,416,676,10,1,0.0,1.0,11,380,205,585,0.865384615
1196006,112,13,260,416,676,10,1,0.0,0.0,8,309,138,447,0.661242604
1196006,112,13,260,416,676,10,1,0.0,1.0,5,310,5,315,0.465976331
1196010,107,9,225,303,528,7,0,0.0,0.0,3,32,184,216,0.409090909
1199001,5272,4,8002,2688,10690,17,0,0.0,4.882353,5,11714,-4164,7550,0.70626754
1201001,112,13,260,416,676,10,1,0.0,1.0,11,297,251,548,0.810650888
1201002,112,9,180,288,468,6,0,0.0,1.0,8,-96,547,451,0.963675214
1203001,100,25,650,650,1300,10,0,0.0,2.3,11,438,338,776,0.596923077
1203002,100,25,650,650,1300,10,0,0.1,2.4,13,360,438,798,0.613846154
1203003,100,25,650,650,1300,10,0,0.0,2.3,17,339,689,1028,0.790769231
1203004,100,25,650,650,1300,10,0,0.0,2.0,9,62,650,712,0.547692308
1203005,100,25,650,650,1300,10,0,0.3,2.3,14,-931,1853,922,0.709230769
1203006,100,25,650,650,1300,10,0,0.0,2.0,6,353,85,438,0.336923077
1203007,100,25,650,650,1300,10,0,0.0,2.3,7,148,446,594,0.456923077
1203008,100,25,650,650,1300,10,0,0.0,2.0,5,183,245,428,0.329230769
1205001,84,5,170,90,260,6,0,0.0,1.0,4,130,14,144,0.553846154
1206001,112,13,260,416,676,10,1,0.0,0.0,11,314,223,537,0.794378698
1206002,112,13,260,416,676,10,1,0.0,0.0,14,381,259,640,0.946745562
1206003,112,13,260,416,676,10,1,0.0,0.0,13,261,391,652,0.964497041
1206004,112,13,260,416,676,10,1,0.0,0.0,10,100,457,557,0.823964497
1206005,112,13,260,416,676,10,1,0.0,0.0,13,594,36,630,0.931952663
1206006,112,13,260,416,676,10,1,0.0,0.0,10,108,468,576,0.852071006
1206007,111,6,135,201,336,4,0,0.0,0.0,4,-40,324,284,0.845238095
1209001,120,26,650,650,1300,20,0,0.0,3.0,16,150,902,1052,0.809230769
1209001,120,26,650,650,1300,20,0,0.0,4.0,15,128,850,978,0.752307692
1209002,120,26,650,650,1300,20,0,0.15,2.85,21,306,932,1238,0.952307692
1209002,120,26,650,650,1300,20,0,0.15,3.85,22,17,1177,1194,0.918461538
1209003,120,26,650,650,1300,20,0,0.15,2.6,12,281,547,828,0.636923077
1209003,120,26,650,650,1300,20,0,0.15,3.6,19,383,707,1090,0.838461538
1209004,120,26,650,650,1300,20,0,0.0,3.0,18,4,1126,1130,0.869230769
1209004,120,26,650,650,1300,20,0,0.0,4.0,16,133,817,950,0.730769231
1209005,120,26,650,650,1300,20,0,0.0,3.0,16,285,773,1058,0.813846154
1209005,120,26,650,650,1300,20,0,0.0,4.0,14,195,807,1002,0.770769231
1209006,120,26,650,650,1300,20,0,0.0,3.0,19,285,817,1102,0.847692308
1209006,120,26,650,650,1300,20,0,0.0,4.0,24,202,1040,1242,0.955384615
1209007,120,26,650,650,1300,20,0,0.45,2.55,17,241,835,1076,0.827692308
1209007,120,26,650,650,1300,20,0,0.45,3.55,18,172,960,1132,0.870769231
1209008,120,9,252,252,504,6,0,0.0,3.0,5,67,295,362,0.718253968
1209008,118,9,270,288,558,7,0,0.0,3.4285715,6,39,393,432,0.774193548
1210001,122,10,145,190,335,14,0,0.35714287,1.5714285,12,64,203,267,0.797014925
1210002,122,10,145,190,335,14,0,0.5,1.4285715,13,120,135,255,0.76119403
1211001,100,7,385,385,770,22,0,0.0,0.0,9,508,-178,330,0.428571429
1212010,98,17,272,408,680,16,0,0.125,3.125,7,30,231,261,0.383823529
1212010,98,17,272,408,680,16,0,0.125,4.125,7,105,172,277,0.407352941
1212011,98,17,272,408,680,16,0,0.0625,3.5,16,51,539,590,0.867647059
1212011,98,17,272,408,680,16,0,0.0625,4.5,17,358,265,623,0.916176471
1212012,98,17,272,408,680,16,0,0.0625,3.6875,13,227,345,572,0.841176471
1212012,98,17,272,408,680,16,0,0.0625,4.6875,16,222,395,617,0.907352941
1212013,98,17,272,408,680,16,0,0.0625,3.625,14,161,315,476,0.7
1212013,98,17,272,408,680,16,0,0.0625,4.625,19,201,440,641,0.942647059
1212014,98,17,272,408,680,16,0,0.25,3.3125,17,431,43,474,0.697058824
1212014,98,17,272,408,680,16,0,0.25,4.3125,17,524,71,595,0.875
1212015,98,17,272,408,680,16,0,0.125,3.5625,18,190,410,600,0.882352941
1212015,98,17,272,408,680,16,0,0.125,4.5625,18,298,345,643,0.945588235
1212016,98,17,272,408,680,16,0,0.0,3.5,17,434,165,599,0.880882353
1212016,98,17,272,408,680,16,0,0.0,4.5,18,258,342,600,0.882352941
1212017,98,17,272,408,680,16,0,0.0625,3.4375,15,393,185,578,0.85
1212017,98,17,272,408,680,16,0,0.0625,4.4375,18,448,151,599,0.880882353
1212018,98,17,272,408,680,16,0,0.0625,3.25,14,48,491,539,0.792647059
1212018,98,17,272,408,680,16,0,0.0625,4.25,17,38,593,631,0.927941176
1212019,98,17,272,408,680,16,0,0.1875,2.875,12,504,1,505,0.742647059
1212019,98,17,272,408,680,16,0,0.1875,3.875,12,444,17,461,0.677941176
1213001,130,11,1265,495,1760,10,0,0.6,2.3,13,883,812,1695,0.963068182
1213002,130,11,1265,495,1760,10,0,0.7,2.2,15,1057,503,1560,0.886363636
1214001,100,7,170,170,340,14,0,0.0,3.0,6,197,135,332,0.976470588
1215001,118,14,602,497,1099,10,0,0.6,0.4,13,365,717,1082,0.984531392
1217001,112,13,260,416,676,10,1,0.0,0.0,13,102,523,625,0.924556213
1217001,112,13,260,416,676,10,1,0.0,1.0,14,476,184,660,0.976331361
1217001,112,13,260,416,676,10,1,0.0,2.0,11,485,106,591,0.874260355
1217001,112,13,260,416,676,10,1,0.0,3.0,10,-188,677,489,0.723372781
1217002,112,13,260,416,676,10,1,0.0,0.0,12,-249,873,624,0.923076923
1217002,112,13,260,416,676,10,1,0.0,1.0,14,-130,785,655,0.968934911
1217002,112,13,260,416,676,10,1,0.0,2.0,12,23,584,607,0.897928994
1217002,112,13,260,416,676,10,1,0.0,3.0,4,133,175,308,0.455621302
1217003,112,13,260,416,676,10,1,0.0,0.0,11,202,340,542,0.801775148
1217003,112,13,260,416,676,10,1,0.0,1.0,10,-170,705,535,0.791420118
1217003,112,13,260,416,676,10,1,0.0,2.0,6,64,302,366,0.541420118
1217003,112,13,260,416,676,10,1,0.0,3.0,6,-57,407,350,0.517751479
1217004,112,13,260,416,676,10,1,0.0,0.5,12,143,517,660,0.976331361
1217004,112,13,260,416,676,10,1,0.0,1.5,12,274,281,555,0.821005917
1217004,112,13,260,416,676,10,1,0.0,2.5,11,152,403,555,0.821005917
1217004,112,13,260,416,676,10,1,0.0,3.5,7,124,264,388,0.573964497
1217005,112,13,260,416,676,10,1,0.0,0.3,13,362,255,617,0.912721893
1217005,112,13,260,416,676,10,1,0.0,1.3,9,200,237,437,0.646449704
1217005,112,13,260,416,676,10,1,0.0,2.3,11,152,374,526,0.778106509
1217005,112,13,260,416,676,10,1,0.0,3.3,1,19,65,84,0.124260355
1217007,112,13,260,416,676,10,1,0.0,0.0,14,689,-27,662,0.979289941
1217007,112,13,260,416,676,10,1,0.0,1.0,12,236,388,624,0.923076923
1217007,112,13,260,416,676,10,1,0.0,2.0,12,624,-69,555,0.821005917
1217007,112,13,260,416,676,10,1,0.0,3.0,8,310,143,453,0.670118343
1218001,107,15,330,435,765,14,0,0.35714287,2.642857,17,-15,749,734,0.959477124
1218002,107,15,330,435,765,14,0,0.5,2.5,16,220,520,740,0.967320261
1220001,111,4,132,156,288,9,0,0.0,0.0,4,11,245,256,0.888888889
1220001,111,4,132,156,288,9,0,0.0,1.0,4,88,200,288,1.0
1220001,111,4,132,156,288,9,0,0.0,2.0,4,23,241,264,0.916666667
1220001,111,4,132,156,288,9,0,0.0,3.0,4,-4,292,288,1.0
1221001,113,60,1300,2160,3460,70,0,0.0,0.0,61,2032,1324,3356,0.969942197
1222001,112,13,260,416,676,10,1,0.0,0.0,14,174,488,662,0.979289941
1222001,112,13,260,416,676,10,1,0.0,1.0,12,59,607,666,0.985207101
1222001,112,13,260,416,676,10,1,0.0,2.0,10,151,411,562,0.831360947
1222001,112,13,260,416,676,10,1,0.0,3.0,13,217,413,630,0.931952663
1222001,112,13,260,416,676,10,1,0.0,4.0,14,-397,1056,659,0.974852071
1222001,112,13,260,416,676,10,1,0.0,5.0,3,33,221,254,0.375739645
1222002,112,13,260,416,676,10,1,0.0,0.0,9,-361,820,459,0.678994083
1222002,112,13,260,416,676,10,1,0.0,1.0,10,16,565,581,0.859467456
1222002,112,13,260,416,676,10,1,0.0,2.0,9,90,461,551,0.815088757
1222002,112,13,260,416,676,10,1,0.0,3.0,10,-230,854,624,0.923076923
1222002,112,13,260,416,676,10,1,0.0,4.0,10,143,403,546,0.807692308
1222003,112,13,260,416,676,10,1,0.0,0.0,14,-236,899,663,0.980769231
1222003,112,13,260,416,676,10,1,0.0,1.0,8,52,432,484,0.715976331
1222003,112,13,260,416,676,10,1,0.0,2.0,8,45,452,497,0.735207101
1222003,112,13,260,416,676,10,1,0.0,3.0,11,-2,643,641,0.948224852
1222003,112,13,260,416,676,10,1,0.0,4.0,10,80,520,600,0.887573964
1224001,91,15,531,387,918,8,0,0.0,0.0,10,-2,737,735,0.800653595
1224001,91,15,531,387,918,8,0,0.0,1.0,9,83,547,630,0.68627451
1224001,91,15,531,387,918,8,0,0.0,2.0,14,112,697,809,0.881263617
1224001,86,16,608,376,984,9,0,0.0,2.6666667,13,217,545,762,0.774390244
1225001,97,44,1118,1139,2257,89,0,0.0,2.764045,24,901,419,1320,0.584847142
1226001,90,45,1620,1485,3105,19,0,0.0,3.0,37,1470,1175,2645,0.851851852
1227001,114,30,645,1050,1695,20,0,1.15,2.85,25,719,818,1537,0.906784661
1227001,114,30,645,1050,1695,20,0,1.15,3.85,24,702,808,1510,0.890855457
1227002,114,30,645,1050,1695,20,0,0.4,3.6,25,600,944,1544,0.910914454
1227002,114,30,645,1050,1695,20,0,0.4,4.6,24,349,1075,1424,0.840117994
1229001,112,13,260,416,676,10,1,0.0,2.0,13,140,531,671,0.99260355
1229002,112,9,180,288,468,6,0,0.0,2.0,5,291,5,296,0.632478632
1231001,78,13,312,156,468,10,0,1.0,6.0,5,-47,251,204,0.435897436
1231001,78,13,312,156,468,10,0,1.0,7.0,4,39,199,238,0.508547009
1231002,78,13,312,156,468,10,0,0.5,5.7,9,-131,519,388,0.829059829
1231002,78,13,312,156,468,10,0,0.5,6.7,5,39,229,268,0.572649573
1231003,78,13,312,156,468,10,0,0.8,5.5,10,-217,603,386,0.824786325
1231003,78,13,312,156,468,10,0,0.8,6.5,5,32,238,270,0.576923077
1231004,78,13,312,156,468,10,0,0.3,5.7,5,18,270,288,0.615384615
1231004,78,13,312,156,468,10,0,0.3,6.7,5,22,258,280,0.598290598
1232001,118,8,144,164,308,27,0,5.0,3.0,11,154,61,215,0.698051948
1232001,118,8,144,164,308,27,0,5.0,4.0,9,239,24,263,0.853896104
1232001,118,8,144,164,308,27,0,5.0,5.0,10,106,142,248,0.805194805
1233001,112,13,260,416,676,10,1,0.0,2.0,6,13,443,456,0.674556213
1233002,112,13,260,416,676,10,1,0.2,1.8,9,-98,690,592,0.875739645
1233003,112,13,260,416,676,10,1,0.4,1.6,7,353,87,440,0.650887574
1233004,112,13,260,416,676,10,1,0.2,2.7,10,43,514,557,0.823964497
1233005,112,13,260,416,676,10,1,0.2,2.2,10,283,224,507,0.75
1233006,112,13,260,416,676,10,1,0.0,2.0,6,98,202,300,0.443786982
1233007,112,13,260,416,676,10,1,0.0,2.0,11,41,535,576,0.852071006
1233008,101,6,195,201,396,5,0,0.0,2.0,5,390,-66,324,0.818181818
1234001,116,17,306,578,884,12,0,0.0,2.0,16,510,332,842,0.952488688
1234002,116,17,306,578,884,12,0,0.0,2.0,15,613,227,840,0.950226244
1235001,112,13,260,416,676,10,1,0.0,1.0,9,119,443,562,0.831360947
1235001,112,13,260,416,676,10,1,0.0,2.0,10,130,500,630,0.931952663
1235002,112,13,260,416,676,10,1,0.0,1.0,9,391,134,525,0.776627219
1235002,112,13,260,416,676,10,1,0.0,2.0,12,502,159,661,0.977810651
1235003,112,13,260,416,676,10,1,0.2,0.8,8,131,403,534,0.789940828
1235003,112,13,260,416,676,10,1,0.2,1.8,10,177,343,520,0.769230769
1235004,112,13,260,416,676,10,1,0.1,0.9,10,-47,664,617,0.912721893
1235004,112,13,260,416,676,10,1,0.1,1.9,12,128,499,627,0.927514793
1235005,112,13,260,416,676,10,1,0.0,1.0,11,362,280,642,0.949704142
1235005,112,13,260,416,676,10,1,0.0,2.0,12,295,351,646,0.955621302
1236001,112,12,228,445,673,10,0,0.0,2.5,15,455,191,646,0.959881129
1236002,104,14,397,414,811,10,0,0.0,2.7,13,81,675,756,0.932182491
1236003,112,13,281,461,742,10,0,0.0,3.5,14,362,370,732,0.986522911
1236004,111,13,276,368,644,10,0,0.0,2.7,14,250,369,619,0.961180124
1236005,109,12,201,398,599,10,0,0.0,2.4,11,130,333,463,0.772954925
1236006,106,13,300,390,690,10,0,0.0,2.9,13,499,142,641,0.928985507
1236007,104,12,250,310,560,10,0,0.0,2.5,15,487,46,533,0.951785714
1236008,102,13,345,274,619,10,0,0.0,2.6,14,-183,801,618,0.998384491
1236009,112,13,251,384,635,10,0,0.0,3.3,12,74,442,516,0.812598425
1236010,108,12,234,258,492,10,0,0.0,2.0,11,262,139,401,0.81504065
1236011,111,13,254,391,645,10,0,0.0,2.5,12,346,211,557,0.863565891
1236012,104,6,109,166,275,5,0,0.0,2.0,6,139,126,265,0.963636364
1237001,100,1,50,50,100,4,0,0.0,0.0,2,-54,134,80,0.8
1238002,100,14,439,499,938,10,0,0.0,0.0,10,-22,739,717,0.764392324
1238002,100,14,439,499,938,10,0,0.0,1.0,12,190,692,882,0.940298507
1238002,99,15,465,564,1029,11,0,0.0,1.8181819,14,152,783,935,0.908649174
1238002,99,15,465,564,1029,11,0,0.0,2.8181818,15,260,669,929,0.90281827
1238002,99,15,465,564,1029,11,0,0.0,3.8181818,10,307,429,736,0.715257532
1239001,112,13,260,416,676,10,1,0.6,4.9,9,455,22,477,0.705621302
1239002,112,13,260,416,676,10,1,0.8,4.6,10,268,305,573,0.847633136
1239003,112,13,260,416,676,10,1,1.0,4.7,8,297,226,523,0.773668639
1240001,112,13,260,416,676,10,1,0.0,1.1,11,341,262,603,0.892011834
1240001,112,13,260,416,676,10,1,0.0,2.1,11,561,47,608,0.899408284
1240002,112,13,260,416,676,10,1,0.1,0.9,8,90,374,464,0.686390533
1240002,112,13,260,416,676,10,1,0.1,1.9,11,-278,894,616,0.911242604
1240003,111,6,135,201,336,4,0,0.0,1.0,3,72,132,204,0.607142857
1240003,111,6,135,201,336,4,0,0.0,2.0,6,52,284,336,1.0
1241001,65,13,780,390,1170,10,0,2.4,4.6,11,35,960,995,0.85042735
1241001,65,13,780,390,1170,10,0,2.4,5.6,8,-207,1087,880,0.752136752
1241002,65,13,780,390,1170,10,0,2.2,4.8,7,356,549,905,0.773504274
1241002,65,13,780,390,1170,10,0,2.2,5.8,7,214,671,885,0.756410256
1241003,57,6,438,207,645,5,0,2.8,4.2,5,136,444,580,0.899224806
1241003,60,9,585,285,870,7,0,2.0,4.285714,7,93,662,755,0.867816092
1242001,118,9,144,216,360,8,0,1.25,0.75,8,151,119,270,0.75
1242002,118,9,144,216,360,8,0,1.125,0.875,11,215,103,318,0.883333333
1242003,118,9,144,216,360,8,0,1.0,1.0,9,-101,329,228,0.633333333
1243001,122,6,93,72,165,12,0,1.75,3.25,6,95,70,165,1.0
1243001,122,6,93,72,165,12,0,1.75,4.25,6,87,74,161,0.975757576
1244001,133,9,198,153,351,12,0,2.6666667,4.5833335,8,244,104,348,0.991452991
1244001,133,9,198,153,351,12,0,2.6666667,5.5833335,8,211,72,283,0.806267806
1245001,65,13,780,390,1170,10,0,0.2,3.8,11,442,673,1115,0.952991453
1245001,65,13,780,390,1170,10,0,0.2,4.8,12,552,598,1150,0.982905983
1245002,65,13,780,390,1170,10,0,0.0,4.0,11,231,814,1045,0.893162393
1245002,65,13,780,390,1170,10,0,0.0,5.0,11,561,514,1075,0.918803419
1245003,65,13,780,390,1170,10,0,0.0,4.0,13,703,427,1130,0.965811966
1245003,65,13,780,390,1170,10,0,0.0,5.0,13,443,717,1160,0.991452991
1246002,112,13,260,416,676,10,1,0.0,0.0,12,-69,690,621,0.918639053
1246003,112,13,260,416,676,10,1,0.0,0.0,12,-318,957,639,0.945266272
1246004,112,13,260,416,676,10,1,0.0,0.0,13,-340,998,658,0.973372781
1246005,112,13,260,416,676,10,1,0.0,0.0,12,262,340,602,0.890532544
1246006,112,13,260,416,676,10,1,0.0,0.0,10,379,170,549,0.812130178
1246007,112,13,260,416,676,10,1,0.0,0.0,13,28,606,634,0.937869822
1246008,112,13,260,416,676,10,1,0.0,0.0,12,-141,782,641,0.948224852
1246009,112,13,260,416,676,10,1,0.0,0.0,13,-120,740,620,0.917159763
1246010,112,13,260,416,676,10,1,0.0,0.0,9,74,470,544,0.804733728
1246011,112,13,260,416,676,10,1,0.0,0.0,14,376,278,654,0.967455621
1246012,112,13,260,416,676,10,1,0.0,0.0,15,493,167,660,0.976331361
1246013,112,13,260,416,676,10,1,0.0,0.0,12,138,477,615,0.909763314
1246014,112,13,260,416,676,10,1,0.0,0.0,10,-372,951,579,0.856508876
1246015,112,13,260,416,676,10,1,0.0,0.0,14,-75,734,659,0.974852071
1246016,112,13,260,416,676,10,1,0.0,0.0,13,143,500,643,0.951183432
1246017,112,13,260,416,676,10,1,0.0,0.0,13,-84,698,614,0.908284024
1246018,112,13,260,416,676,10,1,0.0,0.0,14,-223,877,654,0.967455621
1246019,112,13,260,416,676,10,1,0.0,0.0,14,-29,690,661,0.977810651
1246020,112,13,260,416,676,10,1,0.0,0.0,13,-701,1329,628,0.928994083
1246022,108,12,270,366,636,9,0,0.0,0.0,8,110,344,454,0.713836478
1247001,112,13,260,416,676,10,1,0.6,5.4,11,323,292,615,0.909763314
1247002,112,13,260,416,676,10,1,1.3,4.6,12,181,445,626,0.926035503
1247003,112,13,260,416,676,10,1,1.2,4.8,11,410,185,595,0.880177515
1247004,112,13,260,416,676,10,1,1.2,4.8,12,252,398,650,0.961538462
1247005,112,13,260,416,676,10,1,0.6,6.1,12,409,236,645,0.954142012
1252001,107,15,330,435,765,11,0,0.27272728,2.7272727,5,244,166,410,0.535947712
1254001,4226,22,56298,43109,99407,16,0,1.875,2.0,19,52569,36073,88642,0.891707827
1254001,4226,22,56298,43109,99407,16,0,1.875,3.0,22,32919,60044,92963,0.935175591
1256001,90,7,154,154,308,24,0,1.1666666,2.8333333,3,31,41,72,0.233766234
1256001,90,7,154,154,308,24,0,1.1666666,3.8333333,6,-46,196,150,0.487012987
1256002,90,7,154,154,308,20,0,2.0,2.6,2,-50,132,132,0.428571429
1256002,90,7,154,154,308,20,0,2.0,3.6,6,-22,226,204,0.662337662
1256002,90,7,154,154,308,20,0,2.0,4.6,6,125,43,168,0.545454545
1256004,90,1,40,40,80,2,0,0.0,2.0,1,-80,160,80,1.0
1257001,112,13,260,416,676,10,1,0.0,0.0,9,-78,660,582,0.860946746
1257002,112,13,260,416,676,10,1,0.0,0.0,8,-410,871,461,0.681952663
1257003,112,13,260,416,676,10,1,0.0,0.0,10,296,262,558,0.825443787
1258001,115,12,222,276,498,10,0,0.0,0.0,12,162,323,485,0.973895582
1258002,115,12,222,276,498,10,0,0.0,0.0,11,293,168,461,0.925702811
1258003,115,12,222,276,498,10,0,0.0,0.0,12,284,184,468,0.939759036
1258004,115,12,222,276,498,10,0,0.0,0.0,9,43,404,447,0.897590361
1258005,115,12,222,276,498,10,0,0.0,0.0,12,122,360,482,0.967871486
1258007,115,12,222,276,498,10,0,0.0,0.0,14,367,94,461,0.925702811
1259001,123,10,135,315,450,28,0,0.0,4.0,12,-215,491,276,0.613333333
1259001,123,10,135,315,450,28,0,0.0,5.0,12,-298,654,356,0.791111111
1259001,123,10,135,315,450,28,0,0.0,6.0,12,-133,485,352,0.782222222
1259001,123,10,135,315,450,28,0,0.0,7.0,12,-42,407,365,0.811111111
1261001,111,14,5586,490,6076,11,0,0.09090909,0.0,13,2600,3346,5946,0.978604345
1262001,112,13,260,416,676,10,1,0.0,3.4,10,201,332,533,0.788461538
1262002,112,13,260,416,676,10,1,0.5,3.4,14,254,401,655,0.968934911
1262003,112,13,260,416,676,10,1,0.0,3.2,12,145,465,610,0.902366864
1262004,112,13,260,416,676,10,1,0.0,3.0,13,269,385,654,0.967455621
1262005,112,13,260,416,676,10,1,0.4,3.3,9,225,269,494,0.730769231
1262006,112,9,180,288,468,6,0,0.0,3.0,8,372,86,458,0.978632479
1263001,95,10,135,225,360,10,0,0.3,1.7,10,44,285,329,0.913888889
1263001,95,10,135,225,360,10,0,0.3,2.7,3,48,27,75,0.208333333
1265001,112,13,260,416,676,10,1,0.0,1.0,13,311,302,613,0.906804734
1265002,112,13,260,416,676,10,1,0.0,1.4,12,86,463,549,0.812130178
1265003,112,13,260,416,676,10,1,0.0,1.4,14,210,445,655,0.968934911
1265004,112,13,260,416,676,10,1,0.0,1.7,14,665,-11,654,0.967455621
1265005,112,13,260,416,676,10,1,0.0,2.2,14,27,637,664,0.982248521
1265006,112,13,260,416,676,10,1,0.0,2.0,15,445,215,660,0.976331361
1265007,112,13,260,416,676,10,1,0.0,2.3,12,399,231,630,0.931952663
1265008,112,13,260,416,676,10,1,0.0,1.5,13,346,258,604,0.893491124
1265009,112,13,260,416,676,10,1,0.0,1.4,14,-343,988,645,0.954142012
1265010,112,13,260,416,676,10,1,0.0,2.4,15,91,569,660,0.976331361
1265011,112,13,260,416,676,10,1,0.0,1.4,11,398,187,585,0.865384615
1265012,111,6,135,201,336,4,0,0.0,1.0,5,-163,487,324,0.964285714
1267001,103,205,5596,5435,11031,103,0,0.89320385,0.0,169,2989,6123,9112,0.826035718
1268001,120,11,165,385,550,10,0,0.0,0.0,8,144,357,501,0.910909091
1268002,120,11,165,385,550,10,0,0.0,0.0,12,181,300,481,0.874545455
1268003,120,11,165,385,550,10,0,0.0,0.0,10,227,269,496,0.901818182
1275001,107,4,100,126,226,8,0,0.0,2.0,3,85,111,196,0.867256637
1275001,107,4,100,126,226,8,0,0.0,3.0,4,46,180,226,1.0
1275001,107,4,100,126,226,8,0,0.0,4.0,3,23,144,167,0.738938053
1276001,112,13,260,416,676,10,1,0.0,1.0,9,6,531,537,0.794378698
1276002,112,13,260,416,676,10,1,0.0,1.0,8,128,349,477,0.705621302
1276003,112,13,260,416,676,10,1,0.0,0.8,9,301,252,553,0.818047337
1276004,112,13,260,416,676,10,1,0.0,1.0,10,236,323,559,0.826923077
1276005,112,13,260,416,676,10,1,0.0,1.0,8,205,269,474,0.701183432
1276006,108,12,270,366,636,9,0,0.0,0.8888889,9,-56,606,550,0.864779874
1277001,112,13,260,416,676,10,1,0.4,9.6,13,252,421,673,0.99556213
1277002,112,13,260,416,676,10,1,1.7,8.3,13,335,319,654,0.967455621
1277003,112,13,260,416,676,10,1,1.9,8.1,11,308,287,595,0.880177515
1281001,103,25,725,725,1450,10,0,0.0,3.0,22,58,1324,1382,0.953103448
1281001,103,25,725,725,1450,10,0,0.0,4.0,19,241,1023,1264,0.871724138
1281001,103,25,725,725,1450,10,0,0.0,5.0,22,395,997,1392,0.96
1282001,112,13,260,416,676,10,1,0.0,9.6,12,448,188,636,0.940828402
1282002,112,13,260,416,676,10,1,0.0,11.4,14,321,343,664,0.982248521
1282003,112,9,180,288,468,6,0,0.0,12.0,7,255,173,428,0.914529915
1283001,92,42,1764,903,2667,41,0,0.0,5.97561,46,1590,964,2554,0.957630296
1283001,92,42,1764,903,2667,41,0,0.0,6.97561,43,1566,996,2562,0.960629921
1284001,112,13,260,416,676,10,1,0.2,4.0,13,406,211,617,0.912721893
1284002,112,13,260,416,676,10,1,0.2,3.6,13,361,315,676,1.0
1285001,112,13,260,416,676,10,1,0.0,0.0,14,248,414,662,0.979289941
1285001,112,13,260,416,676,10,1,0.0,1.0,10,460,115,575,0.850591716
1285002,112,13,260,416,676,10,1,0.0,0.0,13,453,187,640,0.946745562
1285002,112,13,260,416,676,10,1,0.0,1.0,11,159,415,574,0.849112426
1286001,94,61,2024,1664,3688,51,0,0.078431375,2.6666667,69,1244,1891,3135,0.85005423
1287001,126,24,300,552,852,20,0,0.65,4.35,25,456,349,805,0.944835681
1287001,126,24,300,552,852,20,0,0.65,5.35,28,452,354,806,0.94600939
1287002,126,24,300,552,852,20,0,0.7,4.1,20,460,232,692,0.812206573
1287002,126,24,300,552,852,20,0,0.7,5.1,20,311,414,725,0.850938967
1287003,126,24,300,552,852,20,0,0.6,4.25,20,340,426,766,0.899061033
1287003,126,24,300,552,852,20,0,0.6,5.25,19,340,387,727,0.853286385
1287004,126,24,300,552,852,20,0,0.45,4.35,22,390,420,810,0.950704225
1287004,126,24,300,552,852,20,0,0.45,5.35,24,335,506,841,0.987089202
1287005,126,24,300,552,852,20,0,1.0,3.5,17,461,225,686,0.805164319
1287005,126,24,300,552,852,20,0,1.0,4.5,22,471,320,791,0.928403756
1287006,126,24,300,552,852,20,0,0.85,4.0,23,519,297,816,0.957746479
1287006,126,24,300,552,852,20,0,0.85,5.0,24,443,389,832,0.976525822
1287007,126,24,300,552,852,20,0,0.3,4.55,18,187,479,666,0.781690141
1287007,126,24,300,552,852,20,0,0.3,5.55,24,379,409,788,0.924882629
1287008,126,24,300,552,852,20,0,0.45,4.4,20,405,318,723,0.848591549
1287008,126,24,300,552,852,20,0,0.45,5.4,22,184,604,788,0.924882629
1287009,126,24,300,552,852,20,0,0.55,3.8,21,558,237,795,0.933098592
1287009,126,24,300,552,852,20,0,0.55,4.8,23,478,285,763,0.895539906
1287010,126,24,300,552,852,20,0,0.7,3.95,24,695,115,810,0.950704225
1287010,126,24,300,552,852,20,0,0.7,4.95,23,473,336,809,0.949530516
1287011,126,24,300,552,852,20,0,0.55,4.2,26,449,377,826,0.969483568
1287011,126,24,300,552,852,20,0,0.55,5.2,24,363,437,800,0.938967136
1287012,126,24,300,552,852,20,0,0.8,3.85,23,779,-23,756,0.887323944
1287012,126,24,300,552,852,20,0,0.8,4.85,22,786,-32,754,0.884976526
1288001,118,9,144,216,360,8,0,0.0,0.0,7,79,241,320,0.888888889
1288001,118,9,144,216,360,8,0,0.0,1.0,9,214,112,326,0.905555556
1288002,118,9,144,216,360,8,0,0.0,0.0,9,235,65,300,0.833333333
1288002,118,9,144,216,360,8,0,0.0,1.0,9,162,138,300,0.833333333
1288003,118,9,144,216,360,8,0,0.0,0.0,11,51,265,316,0.877777778
1288003,118,9,144,216,360,8,0,0.0,1.0,12,-11,311,300,0.833333333
1289001,110,13,234,390,624,10,0,0.0,3.0,10,119,388,507,0.8125
1289002,110,13,234,390,624,10,0,0.5,2.5,12,-14,591,577,0.924679487
1289003,110,13,234,390,624,10,0,0.0,3.0,10,248,309,557,0.892628205
1289004,110,13,234,390,624,10,0,0.0,3.0,11,324,246,570,0.913461538
1289005,110,13,234,390,624,10,0,0.5,2.5,13,386,227,613,0.982371795
1289006,110,13,234,390,624,10,0,2.1,0.9,13,-12,613,601,0.963141026
1292001,133,9,198,153,351,12,0,2.9166667,6.3333335,9,217,122,339,0.965811966
1292001,133,9,198,153,351,12,0,2.9166667,7.3333335,8,198,150,348,0.991452991
1293001,107,4,100,126,226,10,0,0.0,9.3,3,108,81,189,0.836283186
1293001,107,4,100,126,226,10,0,0.0,10.3,4,106,108,214,0.946902655
1293002,102,2,84,87,171,5,0,0.0,12.0,2,61,93,154,0.900584795
1293002,102,2,84,87,171,5,0,0.0,13.0,2,76,95,171,1.0
1296001,112,13,260,416,676,10,1,0.0,0.9,11,311,285,596,0.881656805
1296002,112,13,260,416,676,10,1,0.0,0.7,12,90,576,666,0.985207101
1299001,116,17,306,578,884,12,0,0.0,3.0,7,267,191,458,0.518099548
1299001,116,17,306,578,884,12,0,0.0,4.0,10,469,177,646,0.730769231
1299001,116,17,306,578,884,12,0,0.0,5.0,7,260,214,474,0.536199095
1299002,113,6,144,222,366,4,0,0.0,0.0,2,63,121,184,0.50273224
1300001,107,8,176,232,408,6,0,1.1666666,11.166667,4,82,162,244,0.598039216
1300001,107,8,176,232,408,6,0,1.1666666,12.166667,6,113,245,358,0.87745098
1300001,107,8,176,232,408,6,0,1.1666666,13.166667,8,127,281,408,1.0
1300002,107,8,176,232,408,6,0,1.0,11.333333,8,157,235,392,0.960784314
1300002,107,8,176,232,408,6,0,1.0,12.333333,3,113,97,210,0.514705882
1300002,107,8,176,232,408,6,0,1.0,13.333333,4,56,196,252,0.617647059
1300003,107,8,176,232,408,6,0,0.5,12.0,6,80,238,318,0.779411765
1300003,107,8,176,232,408,6,0,0.5,13.0,6,105,207,312,0.764705882
1300003,107,8,176,232,408,6,0,0.5,14.0,8,117,291,408,1.0
1300004,107,8,176,232,408,6,0,0.0,11.833333,7,185,221,406,0.995098039
1300004,107,8,176,232,408,6,0,0.0,12.833333,6,164,180,344,0.843137255
1300004,107,8,176,232,408,6,0,0.0,13.833333,5,133,143,276,0.676470588
1300005,107,8,176,232,408,6,0,0.5,11.666667,8,286,122,408,1.0
1300005,107,8,176,232,408,6,0,0.5,12.666667,9,219,177,396,0.970588235
1300005,107,8,176,232,408,6,0,0.5,13.666667,7,244,138,382,0.93627451
1300006,107,8,176,232,408,6,0,0.0,12.5,7,-3,393,390,0.955882353
1300006,107,8,176,232,408,6,0,0.0,13.5,6,174,136,310,0.759803922
1300006,107,8,176,232,408,6,0,0.0,14.5,6,190,128,318,0.779411765
1300007,107,8,176,232,408,6,0,0.0,11.833333,9,171,225,396,0.970588235
1300007,107,8,176,232,408,6,0,0.0,12.833333,6,166,136,302,0.740196078
1300007,107,8,176,232,408,6,0,0.0,13.833333,8,196,204,400,0.980392157
1300008,107,8,176,232,408,6,0,0.5,12.333333,8,52,356,408,1.0
1300008,107,8,176,232,408,6,0,0.5,13.333333,6,88,234,322,0.789215686
1300008,107,8,176,232,408,6,0,0.5,14.333333,4,158,78,236,0.578431373
1302004,505,13,3237,3237,6474,10,0,0.4,0.6,8,2340,2013,4353,0.672381835
1302004,505,13,3237,3237,6474,10,0,0.4,1.6,11,461,4935,5396,0.833487797
1302004,505,13,3237,3237,6474,10,0,0.4,2.6,10,80,4121,4201,0.648903306
1302004,505,13,3237,3237,6474,10,0,0.4,3.6,11,2107,1649,3756,0.580166821
1302004,505,13,3237,3237,6474,10,0,0.4,4.6,6,961,3175,4136,0.638863145
1302004,505,13,3237,3237,6474,10,0,0.4,5.6,10,1963,2853,4816,0.743898672
1302005,505,3,870,870,1740,2,0,0.0,0.0,1,218,772,990,0.568965517
1302005,505,3,870,870,1740,2,0,0.0,1.0,2,1031,539,1570,0.902298851
1303001,662,10,2380,1245,3625,34,0,0.0,9.764706,12,1494,1656,3150,0.868965517
1304001,112,13,260,416,676,10,1,0.0,2.8,12,-20,621,601,0.889053254
1304002,112,13,260,416,676,10,1,0.0,3.0,12,284,323,607,0.897928994
1304003,112,13,260,416,676,10,1,0.0,3.2,12,212,386,598,0.884615385
1304004,112,13,260,416,676,10,1,0.0,3.3,11,314,289,603,0.892011834
1304005,112,13,260,416,676,10,1,0.0,1.9,9,-326,809,483,0.714497041
1306001,96,10,155,235,390,10,0,0.2,0.8,14,41,263,304,0.779487179
1306001,96,10,155,235,390,10,0,0.4,3.6,9,74,260,334,0.856410256
1306002,96,10,155,235,390,10,0,0.2,0.8,9,205,170,375,0.961538462
1306002,96,10,155,235,390,10,0,0.6,3.4,9,114,195,309,0.792307692
1308001,110,21,420,630,1050,16,0,0.0,0.9375,21,494,548,1042,0.992380952
1308002,110,21,420,630,1050,16,0,0.0,1.0,18,561,378,939,0.894285714
1308003,110,21,420,630,1050,16,0,0.0,1.0,24,276,744,1020,0.971428571
1308004,110,21,420,630,1050,16,0,0.0,1.0,23,398,619,1017,0.968571429
1308005,110,21,420,630,1050,16,0,0.0625,1.25,18,129,729,858,0.817142857
1308006,110,21,420,630,1050,16,0,0.0625,0.9375,19,337,573,910,0.866666667
1308007,110,21,420,630,1050,16,0,0.25,0.75,19,653,246,899,0.856190476
1310001,115,6,150,210,360,13,0,0.0,0.0,4,171,77,248,0.688888889
1310001,117,7,147,231,378,14,0,0.0,0.9285714,5,150,128,278,0.735449735
1310001,117,7,147,231,378,14,0,0.0,1.9285715,5,140,142,282,0.746031746
1310001,117,7,147,231,378,14,0,0.0,2.9285715,5,119,171,290,0.767195767
1311001,112,13,260,416,676,10,1,0.0,2.4,8,-149,614,465,0.687869822
1311001,112,13,260,416,676,10,1,0.0,3.4,11,-3,585,582,0.860946746
1311001,112,13,260,416,676,10,1,0.0,4.4,10,-88,587,499,0.73816568
1311002,112,13,260,416,676,10,1,0.4,2.3,9,277,307,584,0.863905325
1311002,112,13,260,416,676,10,1,0.4,3.3,11,334,302,636,0.940828402
1311002,112,13,260,416,676,10,1,0.4,4.3,11,393,216,609,0.900887574
1311003,112,13,260,416,676,10,1,0.3,2.1,10,-197,731,534,0.789940828
1311003,112,13,260,416,676,10,1,0.3,3.1,9,118,408,526,0.778106509
1311003,112,13,260,416,676,10,1,0.3,4.1,11,179,417,596,0.881656805
1311004,112,13,260,416,676,10,1,0.0,2.7,10,244,358,602,0.890532544
1311004,112,13,260,416,676,10,1,0.0,3.7,11,456,198,654,0.967455621
1311004,112,13,260,416,676,10,1,0.0,4.7,11,557,65,622,0.920118343
1312001,116,17,306,578,884,12,0,0.75,4.25,14,285,461,746,0.843891403
1312002,116,17,306,578,884,12,0,1.8333334,3.1666667,17,424,444,868,0.981900452
1314001,78,13,312,156,468,10,0,0.1,9.0,10,270,144,414,0.884615385
1314001,78,13,312,156,468,10,0,0.1,10.0,11,366,64,430,0.918803419
1314002,78,13,312,156,468,10,0,1.0,6.6,12,-856,1276,420,0.897435897
1314002,78,13,312,156,468,10,0,1.0,7.6,10,-167,567,400,0.854700855
1314003,78,13,312,156,468,10,0,0.7,7.8,14,282,164,446,0.952991453
1314003,78,13,312,156,468,10,0,0.7,8.8,12,341,105,446,0.952991453
1315001,105,12,276,330,606,9,0,0.0,1.0,8,295,166,461,0.760726073
1315002,105,12,276,330,606,9,0,0.0,1.0,12,407,169,576,0.95049505
1316001,130,15,795,675,1470,10,0,2.1,6.9,13,595,760,1355,0.921768707
1316002,130,15,795,675,1470,10,0,2.7,6.3,13,889,451,1340,0.911564626
1316003,130,15,795,675,1470,10,0,2.2,6.8,14,841,592,1433,0.974829932
1316004,130,15,795,675,1470,10,0,1.9,6.5,14,869,564,1433,0.974829932
1316005,130,15,795,675,1470,10,0,1.7,6.7,13,456,901,1357,0.923129252
1318001,98,15,353,335,688,31,0,0.0,0.0,15,856,-168,688,1.0
1319001,113,28,658,1008,1666,28,0,0.0,2.607143,22,1184,222,1406,0.843937575
1320001,112,13,260,416,676,10,1,0.4,3.6,11,77,565,642,0.949704142
1320002,112,13,260,416,676,10,1,0.4,3.6,10,131,426,557,0.823964497
1320003,112,13,260,416,676,10,1,0.8,3.5,12,272,330,602,0.890532544
1320004,112,13,260,416,676,10,1,0.4,3.6,11,473,141,614,0.908284024
1321001,112,13,260,416,676,10,1,0.6,1.3,12,437,154,591,0.874260355
1321002,112,13,260,416,676,10,1,1.0,1.0,12,377,259,636,0.940828402
1321003,112,13,260,416,676,10,1,1.0,1.0,14,-26,680,654,0.967455621
1321004,112,13,260,416,676,10,1,0.4,1.3,14,524,140,664,0.982248521
1321005,112,13,260,416,676,10,1,0.2,1.6,12,481,154,635,0.939349112
1321006,112,13,260,416,676,10,1,0.6,1.4,15,521,139,660,0.976331361
1321007,112,13,260,416,676,10,1,0.2,1.7,14,100,555,655,0.968934911
1322001,211,23,1035,1288,2323,16,0,0.6875,1.8125,21,1566,640,2206,0.949634094
1322001,211,23,1035,1288,2323,16,0,0.6875,2.8125,21,1717,500,2217,0.95436935
1322001,211,23,1035,1288,2323,16,0,0.6875,3.8125,20,995,1089,2084,0.897115799
1322002,211,23,1035,1288,2323,16,0,0.4375,2.3125,14,1363,319,1682,0.724063711
1322002,211,23,1035,1288,2323,16,0,0.4375,3.3125,18,1319,648,1967,0.846749892
1322002,211,23,1035,1288,2323,16,0,0.4375,4.3125,19,1349,771,2120,0.912613
1322003,211,23,1035,1288,2323,16,0,0.6875,2.25,18,760,1230,1990,0.856650882
1322003,211,23,1035,1288,2323,16,0,0.6875,3.25,19,691,1198,1889,0.813172622
1322003,211,23,1035,1288,2323,16,0,0.6875,4.25,21,1083,1028,2111,0.9087387
1323001,114,30,645,1050,1695,20,0,0.0,0.9,27,330,1228,1558,0.919174041
1323002,114,30,645,1050,1695,20,0,0.0,1.0,24,862,653,1515,0.89380531
1323003,114,30,645,1050,1695,20,0,0.0,0.9,29,580,1096,1676,0.98879056
1323004,114,30,645,1050,1695,20,0,0.0,0.85,23,14,1487,1501,0.885545723
1323005,114,30,645,1050,1695,20,0,0.0,0.95,25,1012,535,1547,0.912684366
1326001,110,13,390,390,780,10,0,0.0,2.0,13,129,611,740,0.948717949
1326002,110,13,390,390,780,10,0,0.0,2.0,14,458,302,760,0.974358974
1326003,110,13,390,390,780,10,0,0.0,2.0,11,289,386,675,0.865384615
1326004,110,13,390,390,780,10,0,0.0,2.0,11,686,-71,615,0.788461538
1326005,110,13,390,390,780,10,0,0.0,2.0,10,243,397,640,0.820512821
1326006,110,13,390,390,780,10,0,0.0,2.0,14,280,465,745,0.955128205
1326007,110,13,390,390,780,10,0,0.0,2.0,10,309,411,720,0.923076923
1326008,110,13,390,390,780,10,0,0.0,2.0,9,327,273,600,0.769230769
1326009,110,13,390,390,780,10,0,0.0,2.0,9,367,313,680,0.871794872
1326010,110,13,390,390,780,10,0,0.0,1.9,12,377,278,655,0.83974359
1326011,110,13,390,390,780,10,0,0.0,2.0,9,314,296,610,0.782051282
1326012,110,13,390,390,780,10,0,0.0,2.0,8,282,298,580,0.743589744
1326013,110,13,390,390,780,10,0,0.0,2.0,12,209,496,705,0.903846154
1326014,110,13,390,390,780,10,0,0.0,2.0,15,433,317,750,0.961538462
1326015,110,13,390,390,780,10,0,0.0,2.0,10,259,411,670,0.858974359
1326016,110,13,390,390,780,10,0,0.0,1.9,14,344,421,765,0.980769231
1326017,110,13,390,390,780,10,0,0.0,2.0,13,-97,842,745,0.955128205
1326018,110,13,390,390,780,10,0,0.0,2.0,12,340,405,745,0.955128205
1326019,110,13,390,390,780,10,0,0.0,2.0,12,525,240,765,0.980769231
1326020,110,13,390,390,780,10,0,0.0,2.0,9,242,343,585,0.75
1326021,110,13,390,390,780,10,0,0.0,2.0,12,58,702,760,0.974358974
1326022,110,13,390,390,780,10,0,0.0,1.9,15,-973,1723,750,0.961538462
1326023,110,13,390,390,780,10,0,0.0,2.0,9,659,-119,540,0.692307692
1326024,110,13,390,390,780,10,0,0.0,1.8,12,459,246,705,0.903846154
1326025,110,9,270,270,540,6,0,0.0,1.8333334,4,284,76,360,0.666666667
1327001,112,13,260,416,676,10,1,0.0,0.0,10,190,379,569,0.841715976
1328001,550,6,1545,1545,3090,20,0,0.05,0.95,5,1146,967,2113,0.68381877
1328001,550,6,1545,1545,3090,20,0,0.05,1.95,5,1038,998,2036,0.658899676
1328002,550,6,1545,1545,3090,20,0,0.0,1.15,6,583,1660,2243,0.725889968
1328002,550,6,1545,1545,3090,20,0,0.0,2.15,4,960,715,1675,0.542071197
1328003,550,6,1545,1545,3090,20,0,0.0,1.0,8,444,2290,2734,0.884789644
1328003,550,6,1545,1545,3090,20,0,0.0,2.0,6,666,1808,2474,0.800647249
1328004,550,6,1545,1545,3090,20,0,0.0,1.0,7,1458,1223,2681,0.86763754
1328004,550,6,1545,1545,3090,20,0,0.0,2.0,2,376,808,1184,0.383171521
1328005,550,6,1545,1545,3090,20,0,0.0,1.35,6,1070,942,2012,0.651132686
1328005,550,6,1545,1545,3090,20,0,0.0,2.35,6,-149,1930,1781,0.576375405
1328006,550,6,1545,1545,3090,20,0,0.0,1.0,5,1709,1174,2883,0.933009709
1328006,550,6,1545,1545,3090,20,0,0.0,2.0,5,857,1487,2344,0.758576052
1328007,550,6,1545,1545,3090,20,0,0.0,1.1,5,240,1334,1574,0.509385113
1328007,550,6,1545,1545,3090,20,0,0.0,2.1,3,479,1143,1622,0.524919094
1328008,550,6,1545,1545,3090,20,0,0.0,0.95,6,747,2112,2859,0.925242718
1328008,550,6,1545,1545,3090,20,0,0.0,1.95,5,849,1572,2421,0.783495146
1328009,550,6,1545,1545,3090,20,0,0.0,0.95,5,952,2008,2960,0.957928803
1328009,550,6,1545,1545,3090,20,0,0.0,1.95,4,1040,866,1906,0.616828479
1328010,550,6,1545,1545,3090,20,0,0.0,1.15,7,57,2316,2373,0.767961165
1328010,550,6,1545,1545,3090,20,0,0.0,2.15,5,568,1853,2421,0.783495146
1329001,99,39,1170,1134,2304,27,0,0.0,1.0,36,934,1157,2091,0.907552083
1330001,110,13,234,390,624,10,0,0.1,1.9,15,324,276,600,0.961538462
1330002,110,13,234,390,624,10,0,0.1,2.9,12,312,292,604,0.967948718
1330003,110,13,234,390,624,10,0,0.1,1.9,8,59,360,419,0.671474359
1330004,110,13,234,390,624,10,0,0.4,1.6,12,212,370,582,0.932692308
1330006,99,6,183,189,372,5,0,0.2,1.8,6,177,105,282,0.758064516
1332001,108,126,2709,3858,6567,100,0,0.11,0.93,87,-1450,5818,4368,0.665143901
1332002,108,126,2709,3858,6567,100,0,0.15,0.87,88,-2113,6756,4643,0.707019948
1332003,108,126,2709,3858,6567,100,0,0.16,0.88,100,-3371,8137,4766,0.725749962
1332004,108,126,2709,3858,6567,100,0,0.21,0.81,106,-505,5649,5144,0.783310492
1332005,115,105,1889,3445,5334,73,0,0.34246576,0.72602737,81,-1660,6138,4478,0.83952006
1333001,99,15,545,115,660,31,0,0.0,0.9677419,13,856,-243,613,0.928787879
1337001,112,13,260,416,676,10,1,0.0,0.0,14,300,360,660,0.976331361
1337002,112,13,260,416,676,10,1,0.0,0.0,14,458,202,660,0.976331361
1337003,112,13,260,416,676,10,1,0.0,0.0,10,323,212,535,0.791420118
1337004,112,13,260,416,676,10,1,0.0,0.0,13,452,191,643,0.951183432
1337005,112,13,260,416,676,10,1,0.0,0.0,13,223,447,670,0.99112426
1337006,112,13,260,416,676,10,1,0.0,0.0,14,405,267,672,0.99408284
1337007,112,13,260,416,676,10,1,0.0,0.0,11,479,148,627,0.927514793
1337008,112,13,260,416,676,10,1,0.0,0.0,12,450,162,612,0.905325444
1337009,112,13,260,416,676,10,1,0.0,0.0,11,409,219,628,0.928994083
1337010,112,13,260,416,676,10,1,0.0,0.0,14,432,234,666,0.985207101
1337011,112,13,260,416,676,10,1,0.0,0.0,11,141,360,501,0.74112426
1337012,112,13,260,416,676,10,1,0.0,0.0,13,288,355,643,0.951183432
1337013,112,13,260,416,676,10,1,0.0,0.0,13,396,236,632,0.934911243
1337014,112,13,260,416,676,10,1,0.0,0.0,13,253,403,656,0.970414201
1337015,112,13,260,416,676,10,1,0.0,0.0,11,321,305,626,0.926035503
1337016,112,13,260,416,676,10,1,0.0,0.0,9,340,250,590,0.872781065
1337017,112,13,260,416,676,10,1,0.0,0.0,12,469,167,636,0.940828402
1340001,112,13,260,416,676,10,1,1.4,3.6,12,241,426,667,0.986686391
1340002,112,13,260,416,676,10,1,0.7,4.3,14,248,419,667,0.986686391
1341001,112,13,260,416,676,10,1,0.0,0.8,7,125,261,386,0.571005917
1341002,112,13,260,416,676,10,1,0.0,0.8,13,18,632,650,0.961538462
1341003,108,12,270,366,636,9,0,0.0,1.0,9,237,318,555,0.872641509
1342001,96,7,210,266,476,10,0,0.0,0.0,6,119,286,405,0.850840336
1342001,96,7,210,266,476,10,0,0.0,1.0,4,126,173,299,0.628151261
1342001,96,7,210,266,476,10,0,0.0,2.0,6,83,262,345,0.724789916
1342001,96,7,210,266,476,10,0,0.0,3.0,6,74,251,325,0.682773109
1342002,96,7,210,266,476,10,0,0.0,0.0,4,17,277,294,0.617647059
1342002,96,7,210,266,476,10,0,0.0,1.0,5,189,124,313,0.657563025
1342002,96,7,210,266,476,10,0,0.0,2.0,6,57,222,279,0.586134454
1342002,96,7,210,266,476,10,0,0.0,3.0,8,200,216,416,0.87394958
1342003,96,7,210,266,476,10,0,0.0,0.0,7,258,188,446,0.93697479
1342003,96,7,210,266,476,10,0,0.0,1.0,7,162,284,446,0.93697479
1342003,96,7,210,266,476,10,0,0.0,2.0,7,218,247,465,0.976890756
1342003,96,7,210,266,476,10,0,0.0,3.0,8,182,229,411,0.863445378
1342004,96,7,210,266,476,10,0,0.0,0.0,6,148,219,367,0.771008403
1342004,96,7,210,266,476,10,0,0.0,1.0,7,182,261,443,0.930672269
1342004,96,7,210,266,476,10,0,0.0,2.0,5,126,228,354,0.743697479
1342004,96,7,210,266,476,10,0,0.0,3.0,7,181,273,454,0.953781513
1342005,96,7,210,266,476,10,0,0.0,0.0,7,186,241,427,0.897058824
1342005,96,7,210,266,476,10,0,0.0,1.0,7,162,284,446,0.93697479
1342005,96,7,210,266,476,10,0,0.0,2.0,6,348,43,391,0.821428571
1342005,96,7,210,266,476,10,0,0.0,3.0,7,104,310,414,0.869747899
1342006,96,7,210,266,476,10,0,0.0,0.0,6,7,383,390,0.819327731
1342006,96,7,210,266,476,10,0,0.0,1.0,7,145,290,435,0.913865546
1342006,96,7,210,266,476,10,0,0.0,2.0,5,166,239,405,0.850840336
1342006,96,7,210,266,476,10,0,0.0,3.0,4,147,228,375,0.787815126
1342007,96,7,210,266,476,10,0,0.0,0.0,8,120,208,328,0.68907563
1342007,96,7,210,266,476,10,0,0.0,1.0,5,143,138,281,0.590336134
1342007,96,7,210,266,476,10,0,0.0,2.0,6,94,270,364,0.764705882
1342007,96,7,210,266,476,10,0,0.0,3.0,7,205,227,432,0.907563025
1342008,96,7,210,266,476,10,0,0.0,0.0,7,156,312,468,0.983193277
1342008,96,7,210,266,476,10,0,0.0,1.0,7,156,320,476,1.0
1342008,96,7,210,266,476,10,0,0.0,2.0,8,201,188,389,0.817226891
1342008,96,7,210,266,476,10,0,0.0,3.0,7,103,324,427,0.897058824
1342009,96,7,210,266,476,10,0,0.0,0.0,9,83,312,395,0.829831933
1342009,96,7,210,266,476,10,0,0.0,1.0,9,-84,468,384,0.806722689
1342009,96,7,210,266,476,10,0,0.0,2.0,8,101,269,370,0.777310924
1342009,96,7,210,266,476,10,0,0.0,3.0,6,11,363,374,0.785714286
1342010,96,7,210,266,476,10,0,0.0,0.0,7,84,357,441,0.926470588
1342010,96,7,210,266,476,10,0,0.0,1.0,7,166,189,355,0.745798319
1342010,96,7,210,266,476,10,0,0.0,2.0,8,-28,428,400,0.840336134
1342010,96,7,210,266,476,10,0,0.0,3.0,7,153,315,468,0.983193277
1342011,96,7,210,266,476,10,0,0.0,0.0,7,-20,395,375,0.787815126
1342011,96,7,210,266,476,10,0,0.0,1.0,7,245,231,476,1.0
1342011,96,7,210,266,476,10,0,0.0,2.0,5,119,294,413,0.867647059
1342011,96,7,210,266,476,10,0,0.0,3.0,6,245,164,409,0.859243697
1342012,96,7,210,266,476,10,0,0.0,0.0,8,91,301,392,0.823529412
1342012,96,7,210,266,476,10,0,0.0,1.0,6,188,236,424,0.890756303
1342012,96,7,210,266,476,10,0,0.0,2.0,7,108,352,460,0.966386555
1342012,96,7,210,266,476,10,0,0.0,3.0,7,214,254,468,0.983193277
1342013,96,7,210,266,476,10,0,0.0,0.0,7,242,199,441,0.926470588
1342013,96,7,210,266,476,10,0,0.0,1.0,6,92,303,395,0.829831933
1342013,96,7,210,266,476,10,0,0.0,2.0,8,158,294,452,0.949579832
1342013,96,7,210,266,476,10,0,0.0,3.0,8,166,302,468,0.983193277
1342014,96,7,210,266,476,10,0,0.0,0.0,7,68,392,460,0.966386555
1342014,96,7,210,266,476,10,0,0.0,1.0,5,135,245,380,0.798319328
1342014,96,7,210,266,476,10,0,0.0,2.0,8,-43,405,362,0.760504202
1342014,96,7,210,266,476,10,0,0.0,3.0,8,-54,479,425,0.892857143
1342015,96,7,210,266,476,10,0,0.0,0.0,6,179,220,399,0.838235294
1342015,96,7,210,266,476,10,0,0.0,1.0,7,171,240,411,0.863445378
1342015,96,7,210,266,476,10,0,0.0,2.0,8,8,364,372,0.781512605
1342015,96,7,210,266,476,10,0,0.0,3.0,7,193,239,432,0.907563025
1342016,96,7,210,266,476,10,0,0.0,0.0,5,132,159,291,0.611344538
1342016,96,7,210,266,476,10,0,0.0,1.0,7,77,375,452,0.949579832
1342016,96,7,210,266,476,10,0,0.0,2.0,7,103,285,388,0.81512605
1342016,96,7,210,266,476,10,0,0.0,3.0,6,184,281,465,0.976890756
1342017,96,7,210,266,476,10,0,0.0,0.0,8,163,253,416,0.87394958
1342017,96,7,210,266,476,10,0,0.0,1.0,6,182,256,438,0.920168067
1342017,96,7,210,266,476,10,0,0.0,2.0,6,210,255,465,0.976890756
1342017,96,7,210,266,476,10,0,0.0,3.0,6,92,305,397,0.834033613
1342018,96,7,210,266,476,10,0,0.0,0.0,7,-226,648,422,0.886554622
1342018,96,7,210,266,476,10,0,0.0,1.0,6,231,218,449,0.943277311
1342018,96,7,210,266,476,10,0,0.0,2.0,6,17,327,344,0.722689076
1342018,96,7,210,266,476,10,0,0.0,3.0,7,169,283,452,0.949579832
1342019,96,7,210,266,476,10,0,0.0,0.0,7,28,408,436,0.915966387
1342019,96,7,210,266,476,10,0,0.0,1.0,3,91,106,197,0.413865546
1342019,96,7,210,266,476,10,0,0.0,2.0,6,78,287,365,0.766806723
1342019,96,7,210,266,476,10,0,0.0,3.0,6,54,269,323,0.678571429
1342020,96,7,210,266,476,10,0,0.0,0.0,8,112,224,336,0.705882353
1342020,96,7,210,266,476,10,0,0.0,1.0,7,10,401,411,0.863445378
1342020,96,7,210,266,476,10,0,0.0,2.0,8,105,311,416,0.87394958
1342020,96,7,210,266,476,10,0,0.0,3.0,7,182,242,424,0.890756303
1342021,96,7,210,266,476,10,0,0.0,0.0,6,60,327,387,0.81302521
1342021,96,7,210,266,476,10,0,0.0,1.0,7,129,248,377,0.792016807
1342021,96,7,210,266,476,10,0,0.0,2.0,6,138,308,446,0.93697479
1342021,96,7,210,266,476,10,0,0.0,3.0,7,191,277,468,0.983193277
1342022,96,7,210,266,476,10,0,0.0,0.0,5,116,273,389,0.817226891
1342022,96,7,210,266,476,10,0,0.0,1.0,9,105,298,403,0.846638655
1342022,96,7,210,266,476,10,0,0.0,2.0,7,137,323,460,0.966386555
1342022,96,7,210,266,476,10,0,0.0,3.0,7,163,283,446,0.93697479
1342023,96,7,210,266,476,10,0,0.0,0.0,8,93,277,370,0.777310924
1342023,96,7,210,266,476,10,0,0.0,1.0,6,117,272,389,0.817226891
1342023,96,7,210,266,476,10,0,0.0,2.0,7,118,282,400,0.840336134
1342023,96,7,210,266,476,10,0,0.0,3.0,7,92,242,334,0.701680672
1342024,96,7,210,266,476,10,0,0.0,0.0,7,85,329,414,0.869747899
1342024,96,7,210,266,476,10,0,0.0,1.0,8,193,226,419,0.880252101
1342024,96,7,210,266,476,10,0,0.0,2.0,7,175,260,435,0.913865546
1342024,96,7,210,266,476,10,0,0.0,3.0,8,108,292,400,0.840336134
1343001,96,10,155,235,390,10,0,0.0,1.0,11,21,291,312,0.8
1343001,96,10,155,235,390,10,0,0.0,2.0,5,131,-13,118,0.302564103
1343002,96,10,155,235,390,10,0,0.4,2.1,10,147,231,378,0.969230769
1343002,96,10,155,235,390,10,0,0.4,3.1,1,39,17,56,0.143589744
1343003,96,10,155,235,390,10,0,0.0,0.9,8,149,114,263,0.674358974
1343003,96,10,155,235,390,10,0,0.0,1.9,6,-137,287,150,0.384615385
1343004,96,10,155,235,390,10,0,0.0,1.0,11,256,99,355,0.91025641
1343004,96,10,155,235,390,10,0,0.0,2.0,1,53,13,66,0.169230769
1343005,96,10,155,235,390,10,0,0.3,0.7,9,192,141,333,0.853846154
1343005,96,10,155,235,390,10,0,0.3,1.7,3,50,7,57,0.146153846
1345001,96,7,210,266,476,10,0,0.8,7.2,8,98,335,433,0.909663866
1345001,96,7,210,266,476,10,0,0.8,8.2,7,-86,488,402,0.844537815
1345002,96,7,210,266,476,10,0,0.2,7.3,7,233,186,419,0.880252101
1345002,96,7,210,266,476,10,0,0.2,8.3,8,129,274,403,0.846638655
1345003,96,7,210,266,476,10,0,0.4,7.6,5,80,311,391,0.821428571
1345003,96,7,210,266,476,10,0,0.4,8.6,6,66,304,370,0.777310924
1345004,96,7,210,266,476,10,0,0.7,7.3,6,94,263,357,0.75
1345004,96,7,210,266,476,10,0,0.7,8.3,6,105,296,401,0.842436975
1345005,96,7,210,266,476,10,0,0.1,7.9,5,161,206,367,0.771008403
1345005,96,7,210,266,476,10,0,0.1,8.9,4,85,247,332,0.697478992
1345006,96,7,210,266,476,10,0,0.3,7.2,5,146,232,378,0.794117647
1345006,96,7,210,266,476,10,0,0.3,8.2,4,133,177,310,0.651260504
1345007,96,7,210,266,476,10,0,0.1,7.9,4,44,264,308,0.647058824
1345007,96,7,210,266,476,10,0,0.1,8.9,5,85,339,424,0.890756303
1345008,96,7,210,266,476,10,0,0.1,7.5,4,55,257,312,0.655462185
1345008,96,7,210,266,476,10,0,0.1,8.5,6,105,316,421,0.884453782
1345009,96,7,210,266,476,10,0,0.4,7.6,4,78,210,288,0.605042017
1345009,96,7,210,266,476,10,0,0.4,8.6,6,139,250,389,0.817226891
1345010,96,7,210,266,476,10,0,0.6,6.3,5,136,299,435,0.913865546
1345010,96,7,210,266,476,10,0,0.6,7.3,6,75,322,397,0.834033613
1345011,96,7,210,266,476,10,0,0.5,7.5,3,80,148,228,0.478991597
1345011,96,7,210,266,476,10,0,0.5,8.5,5,32,347,379,0.796218487
1345012,96,7,210,266,476,10,0,0.2,7.8,4,104,263,367,0.771008403
1345012,96,7,210,266,476,10,0,0.2,8.8,4,100,264,364,0.764705882
1345013,96,7,210,266,476,10,0,0.1,7.9,3,77,193,270,0.567226891
1345013,96,7,210,266,476,10,0,0.1,8.9,7,59,368,427,0.897058824
1345014,96,7,210,266,476,10,0,0.4,7.6,7,38,387,425,0.892857143
1345014,96,7,210,266,476,10,0,0.4,8.6,8,-165,601,436,0.915966387
1345015,96,7,210,266,476,10,0,0.5,7.5,5,76,327,403,0.846638655
1345015,96,7,210,266,476,10,0,0.5,8.5,7,126,284,410,0.861344538
1345016,96,7,210,266,476,10,0,0.1,7.6,7,192,254,446,0.93697479
1345016,96,7,210,266,476,10,0,0.1,8.6,4,140,202,342,0.718487395
1345017,96,7,210,266,476,10,0,0.2,7.8,7,82,394,476,1.0
1345017,96,7,210,266,476,10,0,0.2,8.8,5,73,284,357,0.75
1345018,96,7,210,266,476,10,0,0.1,7.9,5,102,322,424,0.890756303
1345018,96,7,210,266,476,10,0,0.1,8.9,5,93,310,403,0.846638655
1345019,96,7,210,266,476,10,0,0.3,7.7,3,70,188,258,0.542016807
1345019,96,7,210,266,476,10,0,0.3,8.7,4,12,271,283,0.594537815
1345020,96,7,210,266,476,10,0,1.1,6.9,8,8,436,444,0.932773109
1345020,96,7,210,266,476,10,0,1.1,7.9,5,17,350,367,0.771008403
1345022,96,7,210,266,476,10,0,0.7,7.3,7,107,243,350,0.735294118
1345022,96,7,210,266,476,10,0,0.7,8.3,8,99,347,446,0.93697479
1345023,96,7,210,266,476,10,0,0.2,6.7,5,192,177,369,0.775210084
1345023,96,7,210,266,476,10,0,0.2,7.7,6,156,202,358,0.75210084
1345024,96,7,210,266,476,10,0,0.4,7.1,6,107,159,266,0.558823529
1345024,96,7,210,266,476,10,0,0.4,8.1,4,-89,314,225,0.472689076
1345025,91,4,140,176,316,5,0,0.8,6.0,2,69,162,231,0.731012658
1345025,92,6,180,215,395,7,0,0.5714286,6.857143,1,24,93,117,0.296202532
1346001,124,19,551,722,1273,10,0,0.0,2.0,11,255,733,988,0.776119403
1347001,112,13,260,416,676,10,1,0.0,0.0,11,117,526,643,0.951183432
1347002,112,13,260,416,676,10,1,0.0,0.0,9,240,331,571,0.844674556
1347003,112,13,260,416,676,10,1,0.0,0.0,11,406,237,643,0.951183432
1347004,112,13,260,416,676,10,1,0.0,0.0,11,123,506,629,0.930473373
1347005,112,13,260,416,676,10,1,0.0,0.0,11,402,143,545,0.806213018
1347006,112,13,260,416,676,10,1,0.0,0.0,11,54,525,579,0.856508876
1349001,95,10,225,225,450,21,0,0.0,5.714286,10,67,368,435,0.966666667
1349001,95,10,225,225,450,21,0,0.0,6.714286,10,245,170,415,0.922222222
1349001,95,10,225,225,450,21,0,0.0,7.714286,10,272,168,440,0.977777778
1349001,95,10,225,225,450,21,0,0.0,8.714286,10,283,157,440,0.977777778
1349001,95,10,225,225,450,21,0,0.0,9.714286,9,249,116,365,0.811111111
1350001,112,13,260,416,676,10,1,0.0,2.0,15,85,575,660,0.976331361
1351001,107,15,330,435,765,11,0,0.0,4.4545455,9,462,130,592,0.773856209
1351002,107,15,330,435,765,11,0,0.0,5.909091,8,422,83,505,0.660130719
1352001,112,13,260,416,676,10,1,0.7,0.3,10,138,467,605,0.894970414
1352002,112,13,260,416,676,10,1,0.7,0.3,11,278,320,598,0.884615385
1352003,112,13,260,416,676,10,1,0.9,0.1,9,176,338,514,0.76035503
1352004,112,13,260,416,676,10,1,0.9,0.1,11,301,306,607,0.897928994
1352005,112,13,260,416,676,10,1,1.0,0.0,11,166,434,600,0.887573964
1352006,112,13,260,416,676,10,1,0.9,0.1,10,255,259,514,0.76035503
1354001,501,150,33450,33600,67050,150,0,0.06666667,2.04,174,38073,17203,55276,0.824399702
1354001,501,150,33450,33600,67050,150,0,0.06666667,3.04,150,35842,15068,50910,0.759284116
1354002,400,6,1770,1170,2940,5,0,0.0,2.0,3,1582,-412,1170,0.397959184
1356001,91,9,45,189,234,10,0,0.0,0.0,7,4,174,178,0.760683761
1356002,91,9,45,189,234,10,0,0.0,0.5,8,69,118,187,0.799145299
1356003,91,9,45,189,234,10,0,0.0,0.0,8,-49,249,200,0.854700855
1356004,91,9,45,189,234,10,0,0.0,0.0,11,-4,162,158,0.675213675
1356005,91,9,45,189,234,10,0,0.1,0.6,12,-38,213,175,0.747863248
1356006,91,9,45,189,234,10,0,0.0,0.0,10,-13,211,198,0.846153846
1356007,91,9,45,189,234,10,0,0.0,0.0,9,130,53,183,0.782051282
1356008,91,9,45,189,234,10,0,0.0,0.0,8,94,34,128,0.547008547
1359001,112,13,260,416,676,10,1,0.0,2.9,11,269,307,576,0.852071006
1359002,112,13,260,416,676,10,1,0.0,2.3,13,417,235,652,0.964497041
1359003,112,13,260,416,676,10,1,0.0,2.8,13,238,387,625,0.924556213
1359004,112,11,223,357,580,8,0,0.0,2.625,9,244,269,513,0.884482759
1360001,112,13,260,416,676,10,1,0.2,0.8,10,191,362,553,0.818047337
1360001,112,13,260,416,676,10,1,0.2,1.8,13,427,193,620,0.917159763
1360002,112,13,260,416,676,10,1,0.0,0.0,8,312,183,495,0.732248521
1360002,112,13,260,416,676,10,1,0.0,1.0,8,352,207,559,0.826923077
1361001,124,15,375,585,960,10,0,0.0,1.0,10,251,469,720,0.75
1361002,124,15,375,585,960,10,0,0.0,1.0,14,598,336,934,0.972916667
1362001,117,14,952,483,1435,10,0,0.0,0.0,15,666,759,1425,0.993031359
1362002,117,14,952,483,1435,10,0,0.0,0.0,12,175,1100,1275,0.888501742
1363001,90,6,195,135,330,10,0,1.9,13.8,3,128,75,203,0.615151515
1363001,90,6,195,135,330,10,0,1.9,14.8,5,141,147,288,0.872727273
1363002,90,6,195,135,330,10,0,1.6,15.3,6,218,112,330,1.0
1363002,90,6,195,135,330,10,0,1.6,16.3,6,221,109,330,1.0
1363003,90,6,195,135,330,10,0,0.7,14.9,4,78,128,206,0.624242424
1363003,90,6,195,135,330,10,0,0.7,15.9,5,84,208,292,0.884848485
1363004,90,2,65,45,110,2,0,1.5,15.5,1,82,18,100,0.909090909
1365001,108,156,3492,4923,8415,60,0,0.0,4.483333,140,4134,3584,7718,0.917171717
1365002,108,156,3492,4923,8415,60,0,0.0,4.766667,123,4276,2844,7120,0.84610814
1365003,108,156,3492,4923,8415,60,0,0.0,4.9,133,3356,3963,7319,0.869756387
1365004,108,156,3492,4923,8415,60,0,0.0,4.9166665,126,3767,3248,7015,0.833630422
1365005,108,156,3492,4923,8415,60,0,0.0,4.1666665,130,4407,3147,7554,0.897682709
1366001,65,13,780,390,1170,10,0,0.3,6.7,8,113,822,935,0.799145299
1366001,65,13,780,390,1170,10,0,0.3,7.7,8,195,765,960,0.820512821
1366002,65,13,780,390,1170,10,0,0.5,6.7,6,191,554,745,0.636752137
1366002,65,13,780,390,1170,10,0,0.5,7.7,11,223,862,1085,0.927350427
1366003,65,13,780,390,1170,10,0,0.3,6.7,7,338,547,885,0.756410256
1366003,65,13,780,390,1170,10,0,0.3,7.7,6,262,508,770,0.658119658
1366004,65,13,780,390,1170,10,0,0.9,6.9,7,204,676,880,0.752136752
1366004,65,13,780,390,1170,10,0,0.9,7.9,9,263,732,995,0.85042735
1368001,100,10,275,275,550,20,0,0.0,0.0,10,463,32,540,0.981818182
1370001,105,12,276,330,606,9,0,0.0,2.0,10,375,208,583,0.962046205
1370002,105,12,276,330,606,9,0,0.0,2.0,9,245,248,493,0.813531353
1371001,99,10,400,265,665,10,0,0.3,6.7,12,201,441,642,0.965413534
1371001,99,10,400,265,665,10,0,0.3,7.7,9,143,454,597,0.897744361
1371001,99,10,400,265,665,10,0,0.3,8.7,10,219,406,625,0.939849624
1371002,99,10,400,265,665,10,0,0.1,6.9,10,116,521,637,0.957894737
1371002,99,10,400,265,665,10,0,0.1,7.9,10,348,312,660,0.992481203
1371002,99,10,400,265,665,10,0,0.1,8.9,10,53,509,562,0.845112782
1371003,99,10,400,265,665,10,0,0.2,6.8,10,230,407,637,0.957894737
1371003,99,10,400,265,665,10,0,0.2,7.8,12,440,139,579,0.870676692
1371003,99,10,400,265,665,10,0,0.2,8.8,9,164,445,609,0.915789474
1371004,99,10,400,265,665,10,0,0.4,6.6,10,142,485,627,0.942857143
1371004,99,10,400,265,665,10,0,0.4,7.6,9,265,336,601,0.903759398
1371004,99,10,400,265,665,10,0,0.4,8.6,10,295,331,626,0.941353383
1373001,117,3,66,110,176,2,0,0.0,1.0,2,103,39,142,0.806818182
1376001,63,15,675,450,1125,17,0,1.5882353,3.764706,21,359,354,713,0.633777778
1377001,112,13,260,416,676,10,1,0.6,5.4,14,356,302,658,0.973372781
1377002,112,13,260,416,676,10,1,0.5,5.5,15,288,372,660,0.976331361
1377003,112,13,260,416,676,10,1,0.7,5.2,15,500,160,660,0.976331361
1377004,112,13,260,416,676,10,1,0.7,5.2,15,-739,1399,660,0.976331361
1377005,112,13,260,416,676,10,1,0.4,5.6,13,1,640,641,0.948224852
1377006,112,13,260,416,676,10,1,0.3,5.5,12,-232,881,649,0.960059172
1377008,112,13,260,416,676,10,1,0.5,5.3,13,-565,1169,604,0.893491124
1377010,112,13,260,416,676,10,1,0.6,5.3,14,-6,675,669,0.98964497
1378001,65,13,780,390,1170,10,0,0.2,4.8,8,119,671,790,0.675213675
1378001,65,13,780,390,1170,10,0,0.2,5.8,10,-23,1013,990,0.846153846
1378002,65,13,780,390,1170,10,0,0.1,5.9,13,102,1058,1160,0.991452991
1378002,65,13,780,390,1170,10,0,0.1,6.9,8,312,538,850,0.726495726
1378003,65,13,780,390,1170,10,0,0.4,4.4,11,49,981,1030,0.88034188
1378003,65,13,780,390,1170,10,0,0.4,5.4,12,131,954,1085,0.927350427
1378004,65,13,780,390,1170,10,0,0.7,4.0,10,102,963,1065,0.91025641
1378004,65,13,780,390,1170,10,0,0.7,5.0,9,-57,982,925,0.790598291
1380001,240,6,760,760,1520,14,0,0.0,1.1428572,3,300,760,1060,0.697368421
1381001,100,8,204,204,408,10,0,0.9,3.1,9,163,184,347,0.850490196
1381002,100,8,204,204,408,10,0,0.9,3.0,7,-18,354,336,0.823529412
1382001,90,11,275,275,550,8,0,0.5,0.5,14,377,88,465,0.845454545
1383001,112,13,260,416,676,10,1,0.5,0.5,12,-49,683,634,0.937869822
1383002,112,13,260,416,676,10,1,0.1,0.7,14,329,327,656,0.970414201
1386001,260,61,7320,7320,14640,20,0,0.0,3.45,64,9029,3939,12968,0.88579235
1386002,260,55,6696,6696,13392,18,0,0.0,3.0555556,44,6851,2253,9104,0.679808841
1389001,80,9,270,270,540,19,0,0.0,13.210526,6,81,339,420,0.777777778
1389001,80,9,270,270,540,19,0,0.0,14.210526,8,305,175,480,0.888888889
1389001,80,9,270,270,540,19,0,0.0,15.210526,8,316,189,505,0.935185185
1389001,80,9,270,270,540,19,0,0.0,16.210526,7,293,167,460,0.851851852
1391001,112,13,260,416,676,10,1,0.0,4.2,13,503,170,673,0.99556213
1392001,84,5,170,90,260,6,0,0.0,2.0,7,216,-20,196,0.753846154
1393001,100,50,1275,1275,2550,10,0,0.0,2.8,40,-270,2513,2243,0.879607843
1393002,92,20,700,536,1236,5,0,0.0,1.8,20,348,807,1155,0.934466019
1394001,111,120,2340,3828,6168,91,0,0.0,2.3186812,56,-613,3383,2770,0.449092088
1395001,100,8,204,204,408,10,0,2.6,2.1,8,182,212,394,0.965686275
1395001,100,8,204,204,408,10,0,2.6,3.1,8,160,234,394,0.965686275
1395001,100,8,204,204,408,10,0,2.6,4.1,8,158,236,394,0.965686275
1395002,100,8,204,204,408,10,0,1.4,1.8,8,232,141,373,0.914215686
1395002,100,8,204,204,408,10,0,1.4,2.8,8,155,239,394,0.965686275
1395002,100,8,204,204,408,10,0,1.4,3.8,7,90,253,343,0.840686275
1395003,100,8,204,204,408,10,0,0.4,2.7,7,243,135,378,0.926470588
1395003,100,8,204,204,408,10,0,0.4,3.7,8,128,280,408,1.0
1395003,100,8,204,204,408,10,0,0.4,4.7,7,162,160,322,0.789215686
1395004,100,8,204,204,408,10,0,0.8,3.0,7,97,253,350,0.857843137
1395004,100,8,204,204,408,10,0,0.8,4.0,6,184,164,348,0.852941176
1395004,100,8,204,204,408,10,0,0.8,5.0,3,88,100,188,0.460784314
1395005,100,8,204,204,408,10,0,1.3,2.7,8,142,210,352,0.862745098
1395005,100,8,204,204,408,10,0,1.3,3.7,10,-119,489,370,0.906862745
1395005,100,8,204,204,408,10,0,1.3,4.7,6,21,327,348,0.852941176
1401001,110,21,420,630,1050,16,0,0.4375,4.875,20,410,603,1013,0.964761905
1401002,110,21,420,630,1050,16,0,0.1875,5.5625,20,480,431,911,0.867619048
1401003,110,21,420,630,1050,16,0,0.5,5.0625,20,354,661,1015,0.966666667
1401004,110,21,420,630,1050,16,0,0.25,5.4375,19,322,698,1020,0.971428571
1401005,110,21,420,630,1050,16,0,0.0,4.75,21,547,464,1011,0.962857143
1401006,110,21,420,630,1050,16,0,0.25,5.125,22,491,546,1037,0.987619048
1401007,110,21,420,630,1050,16,0,0.375,5.3125,19,337,660,997,0.94952381
1402001,100,24,648,648,1296,13,0,0.0,5.0,19,381,757,1138,0.87808642
1402001,100,24,648,648,1296,13,0,0.0,6.0,19,621,511,1132,0.87345679
1402001,100,24,648,648,1296,13,0,0.0,7.0,13,428,480,908,0.700617284
1403001,126,24,300,552,852,20,0,0.65,5.15,11,64,455,519,0.60915493
1403001,126,24,300,552,852,20,0,0.65,6.15,12,52,500,552,0.647887324
1403002,126,24,300,552,852,20,0,0.55,5.3,11,113,399,512,0.600938967
1403002,126,24,300,552,852,20,0,0.55,6.3,12,96,478,574,0.67370892
1403003,126,24,300,552,852,20,0,0.9,5.95,11,66,520,586,0.687793427
1403003,126,24,300,552,852,20,0,0.9,6.95,11,11,537,548,0.643192488
1403004,126,24,300,552,852,20,0,0.2,6.4,14,49,561,610,0.715962441
1403004,126,24,300,552,852,20,0,0.2,7.4,11,32,533,565,0.66314554
1403005,126,24,300,552,852,20,0,1.1,5.0,12,50,493,543,0.637323944
1403005,126,24,300,552,852,20,0,1.1,6.0,9,74,415,489,0.573943662
1403006,126,24,300,552,852,20,0,0.7,6.1,14,102,570,672,0.788732394
1403006,126,24,300,552,852,20,0,0.7,7.1,12,111,455,566,0.664319249
1403007,126,24,300,552,852,20,0,0.7,5.75,11,57,534,591,0.693661972
1403007,126,24,300,552,852,20,0,0.7,6.75,11,14,537,551,0.646713615
1403008,126,24,300,552,852,20,0,1.2,5.1,17,-66,699,633,0.742957746
1403008,126,24,300,552,852,20,0,1.2,6.1,14,-107,646,539,0.632629108
1403009,126,24,300,552,852,20,0,0.6,6.05,20,-230,937,707,0.829812207
1403009,126,24,300,552,852,20,0,0.6,7.05,15,78,551,629,0.738262911
1403010,126,24,300,552,852,20,0,0.75,5.5,12,112,493,605,0.710093897
1403010,126,24,300,552,852,20,0,0.75,6.5,12,15,560,575,0.674882629
1403013,124,9,135,252,387,7,0,0.85714287,5.142857,4,131,122,253,0.65374677
1405001,112,13,260,416,676,10,1,0.0,0.0,10,112,474,586,0.866863905
1405002,112,13,260,416,676,10,1,0.0,0.0,11,259,333,592,0.875739645
1405003,112,13,260,416,676,10,1,0.0,0.0,11,217,351,568,0.840236686
1405004,112,13,260,416,676,10,1,0.0,0.0,12,251,373,624,0.923076923
1406001,112,13,260,416,676,10,1,0.0,1.0,14,215,447,662,0.979289941
1406002,112,13,260,416,676,10,1,0.0,1.0,11,292,318,610,0.902366864
1406003,112,13,260,416,676,10,1,0.0,1.0,11,195,390,585,0.865384615
1406004,112,13,260,416,676,10,1,0.0,1.0,14,134,520,654,0.967455621
1406005,112,13,260,416,676,10,1,0.0,1.0,15,-417,1077,660,0.976331361
1406007,112,13,260,416,676,10,1,0.0,1.0,13,131,527,658,0.973372781
1408001,141,12,378,564,942,10,0,0.0,2.8,11,522,259,781,0.829087049
1408002,141,12,378,564,942,10,0,0.0,3.0,12,189,663,852,0.904458599
1408003,141,8,262,392,654,6,0,0.0,3.0,6,373,239,612,0.935779817
1411001,114,27,594,972,1566,18,0,0.0,0.0,3,-308,550,242,0.154533844
1412001,78,13,312,156,468,10,0,0.7,7.2,12,122,298,420,0.897435897
1412001,78,13,312,156,468,10,0,0.7,8.2,12,267,133,400,0.854700855
1412002,78,13,312,156,468,10,0,1.0,7.4,13,321,141,462,0.987179487
1412002,78,13,312,156,468,10,0,1.0,8.4,13,212,256,468,1.0
1412003,78,13,312,156,468,10,0,0.9,6.5,10,290,122,412,0.88034188
1412003,78,13,312,156,468,10,0,0.9,7.5,13,311,109,420,0.897435897
1412004,78,13,312,156,468,10,0,0.3,7.0,8,197,183,380,0.811965812
1412004,78,13,312,156,468,10,0,0.3,8.0,10,152,270,422,0.901709402
1412005,78,13,312,156,468,10,0,1.3,6.1,13,55,395,450,0.961538462
1412005,78,13,312,156,468,10,0,1.3,7.1,14,197,253,450,0.961538462
1413001,112,13,260,416,676,10,1,0.3,1.7,12,249,408,657,0.971893491
1413002,112,13,260,416,676,10,1,0.3,1.7,13,343,312,655,0.968934911
1413004,112,13,260,416,676,10,1,0.3,1.7,8,253,224,477,0.705621302
1417001,65,13,780,390,1170,10,0,1.1,6.0,10,135,830,965,0.824786325
1417001,65,13,780,390,1170,10,0,1.1,7.0,11,358,597,955,0.816239316
1417002,65,13,780,390,1170,10,0,1.1,6.3,9,440,515,955,0.816239316
1417002,65,13,780,390,1170,10,0,1.1,7.3,11,133,907,1040,0.888888889
1417003,65,13,780,390,1170,10,0,1.0,6.8,13,359,736,1095,0.935897436
1417003,65,13,780,390,1170,10,0,1.0,7.8,14,561,559,1120,0.957264957
1418001,97,3,114,111,225,3,0,0.0,0.0,3,153,72,225,1.0
1418001,97,3,114,111,225,3,0,0.0,1.0,3,174,51,225,1.0
1419001,108,82,1722,2800,4522,61,0,0.0,0.0,81,1943,2229,4172,0.922600619
1419001,108,82,1722,2800,4522,61,0,0.0,1.0,84,2160,2212,4372,0.966828837
1419001,108,82,1765,2800,4565,62,0,0.0,1.967742,83,2045,2214,4259,0.932968237
1420001,112,13,260,416,676,10,1,0.0,0.0,9,205,355,560,0.828402367
1420002,112,13,260,416,676,10,1,0.0,0.0,9,295,247,542,0.801775148
1420003,112,13,260,416,676,10,1,0.0,1.0,8,380,135,515,0.76183432
1421001,99,42,912,869,1781,85,0,0.0,4.682353,38,1767,-192,1575,0.884334643
1422001,112,13,260,416,676,10,1,0.0,1.0,11,174,391,565,0.835798817
1422002,112,13,260,416,676,10,1,0.2,0.7,12,232,281,513,0.75887574
1422003,112,13,260,416,676,10,1,0.3,0.7,13,221,452,673,0.99556213
1422004,112,13,260,416,676,10,1,0.0,0.9,6,25,257,282,0.417159763
1422005,112,13,260,416,676,10,1,0.1,0.9,12,-188,784,596,0.881656805
1422006,112,13,260,416,676,10,1,0.0,1.0,13,515,146,661,0.977810651
1422007,112,13,260,416,676,10,1,0.1,0.9,12,263,286,549,0.812130178
1422008,112,13,260,416,676,10,1,0.0,0.9,9,264,189,453,0.670118343
1422009,112,13,260,416,676,10,1,0.0,1.0,14,202,470,672,0.99408284
1422010,112,13,260,416,676,10,1,0.0,0.9,13,218,446,664,0.982248521
1422011,112,13,260,416,676,10,1,0.0,1.0,8,196,281,477,0.705621302
1422012,112,13,260,416,676,10,1,0.3,0.7,8,72,360,432,0.639053254
1422013,112,13,260,416,676,10,1,0.3,0.7,12,311,329,640,0.946745562
1422014,112,13,260,416,676,10,1,0.1,0.8,9,88,399,487,0.720414201
1422016,112,13,260,416,676,10,1,0.2,0.8,11,403,132,535,0.791420118
1422017,112,13,260,416,676,10,1,0.1,0.8,11,390,156,546,0.807692308
1422018,112,13,260,416,676,10,1,0.0,0.9,9,431,123,554,0.819526627
1422019,112,13,260,416,676,10,1,0.2,0.8,9,246,271,517,0.764792899
1426001,112,13,260,416,676,10,1,0.2,0.8,11,170,460,630,0.931952663
1426002,112,13,260,416,676,10,1,0.3,0.7,9,56,445,501,0.74112426
1426003,112,13,260,416,676,10,1,0.0,0.9,5,106,212,318,0.470414201
1426004,112,13,260,416,676,10,1,0.3,0.7,8,148,315,463,0.684911243
1428001,52,39,996,819,1815,25,0,0.0,3.12,39,941,842,1783,0.982369146
1429001,100,17,521,600,1121,12,0,0.0,0.0,14,81,891,972,0.867082962
1429001,100,20,600,698,1298,14,0,0.0,0.85714287,16,497,587,1084,0.835130971
1429001,100,20,600,698,1298,14,0,0.0,1.8571428,16,486,568,1054,0.81201849
1429001,100,20,600,698,1298,14,0,0.0,2.857143,15,624,479,1103,0.849768875
1429001,100,20,600,698,1298,14,0,0.0,3.857143,16,769,394,1163,0.895993837
1430001,110,14,287,287,574,10,0,0.0,2.0,10,67,442,509,0.886759582
1430001,110,14,287,287,574,10,0,0.0,3.0,8,26,383,409,0.712543554
1430002,110,14,287,287,574,10,0,0.0,2.0,10,301,160,461,0.803135889
1430002,110,14,287,287,574,10,0,0.0,3.0,12,304,242,546,0.951219512
1430003,110,14,287,287,574,10,0,0.0,2.0,13,239,285,524,0.912891986
1430003,110,14,287,287,574,10,0,0.0,3.0,10,29,429,458,0.797909408
1430004,110,14,287,287,574,10,0,0.0,2.0,9,-368,803,435,0.757839721
1430004,110,14,287,287,574,10,0,0.0,3.0,8,97,252,349,0.608013937
1430005,110,14,287,287,574,10,0,0.0,2.0,11,279,208,487,0.848432056
1430005,110,14,287,287,574,10,0,0.0,3.0,13,291,257,548,0.954703833
1430006,110,14,287,287,574,10,0,0.0,2.0,12,-106,628,522,0.909407666
1430006,110,14,287,287,574,10,0,0.0,3.0,10,193,307,500,0.871080139
1430007,110,14,287,287,574,10,0,0.0,2.0,7,-70,438,368,0.641114983
1430007,110,14,287,287,574,10,0,0.0,3.0,8,157,201,358,0.62369338
1430008,110,14,287,287,574,10,0,0.0,2.0,7,301,79,380,0.662020906
1430008,110,14,287,287,574,10,0,0.0,3.0,7,79,283,362,0.630662021
1430009,110,14,287,287,574,10,0,0.0,2.0,5,-164,447,283,0.493031359
1430009,110,14,287,287,574,10,0,0.0,3.0,3,-60,252,192,0.334494774
1430010,107,9,225,207,432,7,0,0.0,2.0,5,107,146,253,0.585648148
1430010,107,12,282,246,528,9,0,0.0,2.7777777,5,123,181,304,0.575757576
1433001,112,13,260,416,676,10,1,0.0,0.0,11,194,359,553,0.818047337
1433002,112,13,260,416,676,10,1,0.0,0.0,12,417,236,653,0.965976331
1433003,112,13,260,416,676,10,1,0.0,0.0,11,202,366,568,0.840236686
1433004,112,13,260,416,676,10,1,0.0,0.0,8,87,348,435,0.643491124
1433005,112,13,260,416,676,10,1,0.0,0.0,13,120,490,610,0.902366864
1433006,112,13,260,416,676,10,1,0.0,0.0,11,430,132,562,0.831360947
1433007,112,13,260,416,676,10,1,0.0,0.0,13,392,232,624,0.923076923
1433008,112,13,260,416,676,10,1,0.0,0.0,13,537,116,653,0.965976331
1433009,112,13,260,416,676,10,1,0.0,0.0,13,312,316,628,0.928994083
1433010,112,13,260,416,676,10,1,0.0,0.0,11,321,269,590,0.872781065
1433011,112,13,260,416,676,10,1,0.0,0.0,13,616,-16,600,0.887573964
1433012,112,13,260,416,676,10,1,0.0,0.0,11,158,446,604,0.893491124
1433013,112,13,260,416,676,10,1,0.0,0.0,14,648,18,666,0.985207101
1433014,112,13,260,416,676,10,1,0.0,0.0,12,424,144,568,0.840236686
1433015,112,13,260,416,676,10,1,0.0,0.0,10,308,214,522,0.772189349
1433016,112,13,260,416,676,10,1,0.0,0.0,8,-72,489,417,0.616863905
1433017,112,13,260,416,676,10,1,0.0,0.0,10,46,454,500,0.73964497
1433018,112,13,260,416,676,10,1,0.0,0.0,10,470,155,625,0.924556213
1433019,112,13,260,416,676,10,1,0.0,0.0,8,229,189,418,0.618343195
1433020,112,13,260,416,676,10,1,0.0,0.0,10,167,345,512,0.75739645
1433021,112,13,260,416,676,10,1,0.0,0.0,12,305,220,525,0.776627219
1433022,112,13,260,416,676,10,1,0.0,0.0,14,-318,970,652,0.964497041
1433023,112,13,260,416,676,10,1,0.0,0.0,11,500,59,559,0.826923077
1433024,112,13,260,416,676,10,1,0.0,0.0,14,131,541,672,0.99408284
1433025,112,13,260,416,676,10,1,0.0,0.0,10,341,158,499,0.73816568
1433026,112,13,260,416,676,10,1,0.0,0.0,13,314,350,664,0.982248521
1433027,112,13,260,416,676,10,1,0.0,0.0,14,531,135,666,0.985207101
1433028,112,13,260,416,676,10,1,0.0,0.0,12,283,266,549,0.812130178
1433029,112,13,260,416,676,10,1,0.0,0.0,12,243,400,643,0.951183432
1433030,112,13,260,416,676,10,1,0.0,0.0,11,388,209,597,0.883136095
1433031,112,13,260,416,676,10,1,0.0,0.0,11,322,251,573,0.847633136
1433032,112,13,260,416,676,10,1,0.0,0.0,12,4,536,540,0.798816568
1433033,112,13,260,416,676,10,1,0.0,0.0,13,437,202,639,0.945266272
1433034,112,13,260,416,676,10,1,0.0,0.0,14,247,410,657,0.971893491
1433035,112,13,260,416,676,10,1,0.0,0.0,13,182,448,630,0.931952663
1433036,112,13,260,416,676,10,1,0.0,0.0,8,257,220,477,0.705621302
1433037,112,13,260,416,676,10,1,0.0,0.0,12,119,495,614,0.908284024
1433038,112,13,260,416,676,10,1,0.0,0.0,13,117,509,626,0.926035503
1433039,112,13,260,416,676,10,1,0.0,0.0,12,439,173,612,0.905325444
1433040,112,13,260,416,676,10,1,0.0,0.0,12,123,411,534,0.789940828
1433041,112,13,260,416,676,10,1,0.0,0.0,14,-242,890,648,0.958579882
1435001,3978,23,61916,42435,104351,17,0,0.0,5.882353,24,54330,45749,100079,0.959061245
1437001,112,13,260,416,676,10,1,0.8,1.2,15,294,366,660,0.976331361
1440001,97,44,1076,1063,2139,89,0,0.0,5.5842695,42,1344,676,2020,0.944366526
1441001,112,13,260,416,676,10,1,0.0,0.0,11,3,543,546,0.807692308
1441002,112,11,223,357,580,8,0,0.0,0.0,8,283,237,520,0.896551724
1442001,96,10,155,235,390,10,0,0.0,3.0,8,65,296,361,0.925641026
1442001,96,10,155,235,390,10,0,0.0,4.0,9,120,247,367,0.941025641
1442002,96,10,155,235,390,10,0,0.4,2.6,6,277,42,319,0.817948718
1442002,96,10,155,235,390,10,0,0.4,3.6,10,172,149,321,0.823076923
1442003,96,10,155,235,390,10,0,0.2,2.8,9,-116,384,268,0.687179487
1442003,96,10,155,235,390,10,0,0.2,3.8,10,111,255,366,0.938461538
1442004,96,10,155,235,390,10,0,0.0,3.0,7,66,256,322,0.825641026
1442004,96,10,155,235,390,10,0,0.0,4.0,10,108,262,370,0.948717949
1443001,114,4,114,150,264,8,0,0.0,4.0,4,20,244,264,1.0
1443001,114,4,114,150,264,8,0,0.0,5.0,4,2,262,264,1.0
1443001,114,4,114,150,264,8,0,0.0,6.0,4,97,167,264,1.0
1443001,114,4,114,150,264,8,0,0.0,7.0,3,-3,203,200,0.757575758
1444001,65,13,780,390,1170,10,0,0.5,4.1,15,447,678,1125,0.961538462
1445001,112,13,260,416,676,10,1,0.0,0.0,7,-15,446,431,0.637573964
1445002,111,6,135,201,336,4,0,0.0,0.0,2,-205,397,192,0.571428571
1448001,65,13,780,390,1170,10,0,0.4,4.6,14,231,894,1125,0.961538462
1448001,65,13,780,390,1170,10,0,0.4,5.6,12,539,571,1110,0.948717949
1448002,65,13,780,390,1170,10,0,0.9,4.1,10,469,551,1020,0.871794872
1448002,65,13,780,390,1170,10,0,0.9,5.1,11,309,741,1050,0.897435897
1448003,65,13,780,390,1170,10,0,0.2,2.8,9,419,361,780,0.666666667
1448003,65,13,780,390,1170,10,0,0.2,3.8,13,366,744,1110,0.948717949
1448004,65,13,780,390,1170,10,0,0.3,3.7,7,553,242,795,0.679487179
1448004,65,13,780,390,1170,10,0,0.3,4.7,10,602,393,995,0.85042735
1449001,112,13,260,416,676,10,1,0.2,1.6,12,249,372,621,0.918639053
1449001,112,13,260,416,676,10,1,0.2,2.6,12,221,410,631,0.933431953
1449001,112,13,260,416,676,10,1,0.2,3.6,12,299,334,633,0.936390533
1449002,112,13,260,416,676,10,1,0.6,1.4,13,409,189,598,0.884615385
1449002,112,13,260,416,676,10,1,0.6,2.4,13,369,296,665,0.983727811
1449002,112,13,260,416,676,10,1,0.6,3.4,13,318,314,632,0.934911243
1449003,112,13,260,416,676,10,1,0.4,1.6,13,146,498,644,0.952662722
1449003,112,13,260,416,676,10,1,0.4,2.6,14,291,376,667,0.986686391
1449003,112,13,260,416,676,10,1,0.4,3.6,12,277,338,615,0.909763314
1449004,112,13,260,416,676,10,1,0.4,1.4,13,139,501,640,0.946745562
1449004,112,13,260,416,676,10,1,0.4,2.4,9,237,305,542,0.801775148
1449004,112,13,260,416,676,10,1,0.4,3.4,10,266,326,592,0.875739645
1454001,113,27,648,999,1647,18,0,0.0,1.0,21,161,1208,1369,0.831208257
1455001,108,616,12809,17664,30473,297,0,0.0,2.0,411,18914,2639,21583,0.708266334
1457001,108,9,198,270,468,10,0,0.3,12.5,7,236,197,433,0.925213675
1457001,108,9,198,270,468,10,0,0.3,13.5,9,59,342,401,0.856837607
1457002,108,9,198,270,468,10,0,0.5,12.3,6,196,150,346,0.739316239
1457002,108,9,198,270,468,10,0,0.5,13.3,6,186,199,385,0.822649573
1457003,108,9,198,270,468,10,0,1.1,10.5,7,85,246,331,0.707264957
1457003,108,9,198,270,468,10,0,1.1,11.5,9,384,-29,355,0.758547009
1458001,95,10,135,225,360,10,0,0.0,0.0,9,309,-34,275,0.763888889
1458001,95,10,135,225,360,10,0,0.0,1.0,10,142,136,278,0.772222222
1458002,95,10,135,225,360,10,0,0.0,0.0,8,272,57,329,0.913888889
1458002,95,10,135,225,360,10,0,0.0,1.0,9,189,43,232,0.644444444
1458003,95,10,135,225,360,10,0,0.0,0.0,7,222,99,321,0.891666667
1458003,95,10,135,225,360,10,0,0.0,1.0,10,121,195,316,0.877777778
1458004,95,10,135,225,360,10,0,0.0,0.0,8,74,250,324,0.9
1458004,95,10,135,225,360,10,0,0.0,1.0,9,111,208,319,0.886111111
1458005,95,10,135,225,360,10,0,0.1,0.0,8,-260,502,242,0.672222222
1458005,95,10,135,225,360,10,0,0.1,1.0,10,-332,578,246,0.683333333
1458006,94,8,128,192,320,8,0,0.0,0.0,6,42,225,267,0.834375
1458006,94,8,128,192,320,8,0,0.0,1.0,8,103,166,269,0.840625
1459001,106,3,78,96,174,2,0,0.0,2.0,2,43,115,158,0.908045977
1462001,119,8,136,248,384,22,0,0.0,3.8636363,10,-1,269,268,0.697916667
1462001,119,8,136,248,384,22,0,0.0,4.8636365,9,-3,261,258,0.671875
1462001,119,8,136,248,384,22,0,0.0,5.8636365,9,-70,396,326,0.848958333
1462001,119,8,136,248,384,22,0,0.0,6.8636365,11,-148,478,330,0.859375
1463001,100,2,50,50,100,4,0,0.0,0.0,2,104,-4,100,1.0
1464001,78,13,312,156,468,10,0,1.0,5.0,6,91,239,330,0.705128205
1464001,78,13,312,156,468,10,0,1.0,6.0,7,88,278,366,0.782051282
1464002,78,13,312,156,468,10,0,0.8,5.2,8,79,317,396,0.846153846
1464002,78,13,312,156,468,10,0,0.8,6.2,5,77,223,300,0.641025641
1464003,78,13,312,156,468,10,0,0.5,5.5,5,4,290,294,0.628205128
1464003,78,13,312,156,468,10,0,0.5,6.5,6,59,249,308,0.658119658
1465001,65,13,780,390,1170,10,0,0.2,3.8,11,456,629,1085,0.927350427
1465001,65,13,780,390,1170,10,0,0.2,4.8,9,199,801,1000,0.854700855
1465002,65,13,780,390,1170,10,0,0.0,3.9,12,401,599,1000,0.854700855
1465002,65,13,780,390,1170,10,0,0.0,4.9,12,462,578,1040,0.888888889
1465003,65,13,780,390,1170,10,0,0.0,4.0,13,310,860,1170,1.0
1465003,65,13,780,390,1170,10,0,0.0,5.0,12,478,557,1035,0.884615385
1470001,80,12,444,498,942,39,0,0.0,2.0,13,115,636,751,0.797239915
1471001,114,27,594,972,1566,18,0,0.0,0.0,27,1032,534,1566,1.0
1475002,220,3,60,120,180,4,0,0.75,2.25,3,135,45,180,1.0
1475003,220,3,60,120,180,4,0,0.5,1.5,5,87,-17,70,0.388888889
1475004,220,3,60,120,180,4,0,1.5,1.5,2,108,22,130,0.722222222
1475005,220,3,60,120,180,4,0,0.75,1.5,2,81,69,150,0.833333333
1475006,220,3,60,120,180,4,0,0.75,2.25,3,128,52,180,1.0
1475007,220,3,60,120,180,4,0,0.0,3.0,4,66,94,160,0.888888889
1475008,220,3,60,120,180,4,0,0.0,3.0,3,19,151,170,0.944444444
1475009,220,3,60,120,180,4,0,0.0,3.0,5,278,-178,100,0.555555556
1475010,220,3,60,120,180,4,0,0.75,2.25,1,36,54,90,0.5
1478001,100,15,495,495,990,10,0,0.0,0.0,11,169,614,783,0.790909091
1479001,108,12,300,390,690,8,0,0.0,1.875,1,-150,247,97,0.14057971
1479001,108,12,300,390,690,8,0,0.0,2.875,1,-21,106,85,0.123188406
1479001,108,12,300,390,690,8,0,0.0,3.875,3,-194,466,272,0.394202899
1479001,108,12,300,390,690,8,0,0.0,4.875,1,-24,111,87,0.126086957
1479001,108,12,300,390,690,8,0,0.0,5.875,1,146,-50,96,0.139130435
1479001,108,12,300,390,690,8,0,0.0,6.875,2,260,-70,190,0.275362319
1479001,108,12,300,390,690,8,0,0.0,7.875,5,543,-163,380,0.550724638
1479001,108,12,300,390,690,8,0,0.0,8.875,3,185,87,272,0.394202899
1479001,108,12,300,390,690,8,0,0.0,9.875,3,231,23,254,0.368115942
1480001,100,7,170,170,340,14,0,0.0,4.0,7,225,115,340,1.0
1481001,115,30,1215,1215,2430,20,0,0.45,6.05,15,1152,248,1400,0.576131687
1481001,115,30,1215,1215,2430,20,0,0.45,7.05,13,-329,1632,1303,0.536213992
1481001,115,30,1215,1215,2430,20,0,0.45,8.05,17,1002,550,1552,0.638683128
1481001,115,30,1215,1215,2430,20,0,0.45,9.05,22,478,1431,1909,0.785596708
1481001,115,30,1215,1215,2430,20,0,0.45,10.05,18,904,693,1597,0.657201646
1481001,115,30,1215,1215,2430,20,0,0.45,11.05,21,1222,633,1855,0.763374486
1482001,112,13,260,416,676,10,1,0.7,5.9,5,75,280,355,0.525147929
1482002,112,13,260,416,676,10,1,1.5,3.6,8,334,139,473,0.699704142
1482003,112,13,260,416,676,10,1,0.6,5.0,3,133,32,165,0.24408284
1483001,96,24,300,552,852,10,0,0.0,3.0,10,-50,576,526,0.617370892
1483001,96,24,300,552,852,10,0,0.0,4.0,21,653,169,822,0.964788732
1483001,96,24,300,552,852,10,0,0.0,5.0,22,54,772,826,0.969483568
1483002,85,5,125,131,256,3,0,0.0,3.0,4,35,179,214,0.8359375
1483002,85,5,125,131,256,3,0,0.0,4.0,3,15,144,159,0.62109375
1483002,85,5,125,131,256,3,0,0.0,5.0,3,119,64,183,0.71484375
1484001,112,13,260,416,676,10,1,0.8,1.2,12,65,580,645,0.954142012
1485001,99,10,400,265,665,10,0,1.7,4.3,9,86,325,411,0.618045113
1485001,99,10,400,265,665,10,0,1.7,5.3,9,404,115,519,0.780451128
1485001,99,10,400,265,665,10,0,1.7,6.3,8,113,286,399,0.6
1485002,99,10,400,265,665,10,0,1.3,4.7,11,420,224,644,0.968421053
1485002,99,10,400,265,665,10,0,1.3,5.7,10,391,264,655,0.984962406
1485002,99,10,400,265,665,10,0,1.3,6.7,11,481,137,618,0.929323308
1485003,99,10,400,265,665,10,0,1.0,5.0,10,308,263,571,0.858646617
1485003,99,10,400,265,665,10,0,1.0,6.0,10,341,228,569,0.855639098
1485003,99,10,400,265,665,10,0,1.0,7.0,12,276,330,606,0.911278195
1485004,99,10,400,265,665,10,0,0.8,5.2,9,260,320,580,0.872180451
1485004,99,10,400,265,665,10,0,0.8,6.2,9,324,290,614,0.923308271
1485004,99,10,400,265,665,10,0,0.8,7.2,9,203,399,602,0.905263158
1486001,110,13,234,390,624,10,0,0.0,2.0,12,198,410,608,0.974358974
1486002,110,13,234,390,624,10,0,0.0,2.0,10,161,436,597,0.956730769
1486003,110,13,234,390,624,10,0,0.1,1.9,12,362,227,589,0.943910256
1489001,112,13,260,416,676,10,1,0.0,0.0,13,-113,770,657,0.971893491
1492001,98,40,1140,1070,2210,17,0,0.0,5.0,28,-156,1991,1835,0.830316742
1493001,112,13,260,416,676,10,1,0.0,1.0,14,-106,778,672,0.99408284
1493002,112,13,260,416,676,10,1,0.0,1.0,14,30,610,640,0.946745562
1493003,112,13,260,416,676,10,1,0.0,1.0,15,700,-40,660,0.976331361
1493004,112,13,260,416,676,10,1,0.1,0.9,14,43,613,656,0.970414201
1493005,112,13,260,416,676,10,1,0.0,1.0,14,266,394,660,0.976331361
1493006,112,13,260,416,676,10,1,0.0,1.0,14,230,418,648,0.958579882
1493007,112,13,260,416,676,10,1,0.0,1.0,14,393,265,658,0.973372781
1493008,112,13,260,416,676,10,1,0.2,0.8,14,-259,926,667,0.986686391
1493009,112,13,260,416,676,10,1,0.4,1.1,14,-13,669,656,0.970414201
1494001,97,67,1122,1850,2972,60,0,0.0,2.0333333,65,611,1710,2321,0.780955585
1494001,97,67,1122,1850,2972,60,0,0.0,3.0333333,79,908,1775,2683,0.902759085
1494001,97,67,1122,1850,2972,60,0,0.0,4.0333333,81,232,2474,2706,0.910497981
1494001,97,67,1122,1850,2972,60,0,0.0,5.0333333,72,551,2107,2658,0.894347241
1494002,97,67,1122,1850,2972,60,0,0.0,1.95,61,674,1784,2458,0.82705249
1494002,97,67,1122,1850,2972,60,0,0.0,2.95,68,224,2361,2585,0.869784657
1494002,97,67,1122,1850,2972,60,0,0.0,3.95,71,629,1975,2604,0.876177658
1494002,97,67,1122,1850,2972,60,0,0.0,4.95,69,895,1861,2756,0.927321669
1494003,97,67,1122,1850,2972,60,0,0.0,2.0,63,1548,988,2536,0.853297443
1494003,97,67,1122,1850,2972,60,0,0.0,3.0,71,1068,1348,2416,0.812920592
1494003,97,67,1122,1850,2972,60,0,0.0,4.0,71,760,1899,2659,0.894683715
1494003,97,67,1122,1850,2972,60,0,0.0,5.0,73,1303,1391,2694,0.906460296
1494004,97,67,1122,1850,2972,60,0,0.0,2.0,68,214,2294,2508,0.843876178
1494004,97,67,1122,1850,2972,60,0,0.0,3.0,62,802,1703,2505,0.842866756
1494004,97,67,1122,1850,2972,60,0,0.0,4.0,71,640,1983,2623,0.882570659
1494004,97,67,1122,1850,2972,60,0,0.0,5.0,64,496,2178,2674,0.899730821
1494005,95,39,780,1004,1784,34,0,0.0,2.0,28,365,884,1249,0.700112108
1494005,95,39,780,1004,1784,34,0,0.0,3.0,39,552,999,1551,0.869394619
1494005,94,40,820,1031,1851,35,0,0.0,3.942857,39,746,861,1607,0.868179363
1494005,95,41,807,1071,1878,36,0,0.0,4.8055553,36,39,1401,1440,0.766773163
1495001,118,8,144,164,308,9,0,0.0,1.7777778,10,174,94,268,0.87012987
1495002,118,8,144,164,308,9,0,0.0,1.7777778,8,166,128,294,0.954545455
1496001,112,13,260,416,676,10,1,1.0,0.0,15,681,-21,660,0.976331361
1497001,98,17,464,408,872,27,0,0.0,0.0,16,233,425,658,0.754587156
1497001,98,17,464,408,872,27,0,0.0,1.0,18,337,416,753,0.86353211
1497001,98,17,464,408,872,27,0,0.0,2.0,16,302,428,730,0.837155963
1497001,98,17,464,408,872,27,0,0.0,3.0,17,272,474,746,0.855504587
1497001,98,17,464,408,872,27,0,0.0,4.0,18,417,405,822,0.94266055
1497001,98,17,464,408,872,27,0,0.0,5.0,17,448,382,830,0.951834862
1503001,65,13,780,390,1170,10,0,1.0,3.5,7,143,702,845,0.722222222
1503002,65,13,780,390,1170,10,0,0.2,4.9,12,175,945,1120,0.957264957
1503003,65,13,780,390,1170,10,0,1.1,3.9,10,340,735,1075,0.918803419
1503004,57,6,438,207,645,5,0,1.8,2.6,2,204,91,295,0.457364341
1504001,112,13,260,416,676,10,1,1.2,3.8,11,153,458,611,0.903846154
1504002,112,13,260,416,676,10,1,0.9,4.1,12,217,428,645,0.954142012
1506001,112,13,260,416,676,10,1,0.4,0.6,14,223,449,672,0.99408284
1507001,75,8,116,312,428,10,0,0.4,3.5,12,-32,312,280,0.654205607
1507002,75,8,116,312,428,10,0,0.9,2.9,12,-330,612,282,0.658878505
1508001,112,13,260,416,676,10,1,0.0,0.0,13,92,548,640,0.946745562
1510001,93,192,3168,4352,7520,60,0,0.0,1.05,212,4218,2360,6578,0.874734043
1510001,93,192,3168,4352,7520,60,0,0.0,2.05,177,3121,2520,5641,0.750132979
1510002,93,192,3168,4352,7520,60,0,0.0,1.0,188,3007,3505,6512,0.865957447
1510002,93,192,3168,4352,7520,60,0,0.0,2.0,152,2955,2744,5699,0.757845745
1510003,93,192,3168,4352,7520,60,0,0.0,1.1,193,2894,3575,6469,0.860239362
1510003,93,192,3168,4352,7520,60,0,0.0,2.1,194,1974,4171,6145,0.817154255
1510004,93,192,3168,4352,7520,60,0,0.0,1.0,172,2998,3429,6427,0.854654255
1510004,93,192,3168,4352,7520,60,0,0.0,2.0,175,2678,2970,5648,0.75106383
1510005,93,192,3168,4352,7520,60,0,0.0,1.0833334,198,2211,4048,6259,0.83231383
1510005,93,192,3168,4352,7520,60,0,0.0,2.0833333,168,682,4635,5317,0.707047872
1510006,93,83,1391,1798,3189,26,0,0.0,0.9230769,66,1202,1164,2366,0.741925368
1510006,92,94,1583,2020,3603,29,0,0.0,1.8275862,62,1025,1347,2372,0.658340272
1512001,112,13,260,416,676,10,1,0.0,1.0,14,387,279,666,0.985207101
1512002,112,13,260,416,676,10,1,0.0,1.0,14,275,379,654,0.967455621
1512003,112,13,260,416,676,10,1,0.0,1.0,12,328,303,631,0.933431953
1512004,112,13,260,416,676,10,1,0.0,1.0,11,341,297,638,0.943786982
1512005,112,13,260,416,676,10,1,0.0,1.0,12,179,465,644,0.952662722
1512006,112,13,260,416,676,10,1,0.1,0.9,13,440,209,649,0.960059172
1512007,112,13,260,416,676,10,1,0.1,0.8,11,91,430,521,0.770710059
1512008,112,13,260,416,676,10,1,0.1,0.9,12,146,503,649,0.960059172
1512009,112,13,260,416,676,10,1,0.0,1.0,10,154,433,587,0.868343195
1512010,112,13,260,416,676,10,1,0.1,0.9,11,59,568,627,0.927514793
1512011,112,13,260,416,676,10,1,0.1,0.9,13,246,399,645,0.954142012
1512012,112,13,260,416,676,10,1,0.0,1.0,13,266,397,663,0.980769231
1512013,112,13,260,416,676,10,1,0.0,1.0,12,274,355,629,0.930473373
1512014,112,13,260,416,676,10,1,0.0,0.9,14,332,329,661,0.977810651
1512015,112,13,260,416,676,10,1,0.0,1.0,13,258,388,646,0.955621302
1513001,93,39,883,850,1733,78,0,0.0,6.820513,26,658,575,1233,0.711482977
1514001,120,6,105,195,300,12,0,0.0,0.0,3,-88,191,103,0.343333333
1514001,120,6,105,195,300,12,0,0.0,1.0,5,93,133,226,0.753333333
1514001,120,6,105,195,300,12,0,0.0,2.0,5,96,151,247,0.823333333
1514001,120,6,105,195,300,12,0,0.0,3.0,5,87,128,215,0.716666667
1515001,118,14,602,497,1099,10,0,2.3,8.1,13,215,827,1042,0.948134668
1515002,118,14,602,497,1099,10,0,2.4,8.6,12,704,270,974,0.886260237
1515003,118,14,602,497,1099,10,0,2.5,8.4,12,511,506,1017,0.925386715
1515004,118,14,602,497,1099,10,0,1.9,8.5,13,339,681,1020,0.92811647
1515005,118,14,602,497,1099,10,0,2.6,8.3,13,30,1020,1050,0.955414013
1518001,112,13,260,416,676,10,1,0.1,1.4,12,303,351,654,0.967455621
1518002,112,13,260,416,676,10,1,0.0,1.0,11,113,443,556,0.822485207
1518003,112,13,260,416,676,10,1,0.1,1.0,10,183,393,576,0.852071006
1518004,112,13,260,416,676,10,1,0.0,1.0,6,229,170,399,0.590236686
1518005,112,13,260,416,676,10,1,0.1,0.9,13,-463,1129,666,0.985207101
1519001,100,13,338,338,676,16,0,0.0,1.0,15,264,352,616,0.911242604
1521001,110,21,420,420,840,20,0,0.0,5.0,22,24,732,756,0.9
1521001,110,21,420,420,840,20,0,0.0,6.0,20,197,549,746,0.888095238
1521002,110,21,420,420,840,20,0,0.6,4.1,22,433,327,760,0.904761905
1521002,110,21,420,420,840,20,0,0.6,5.1,23,394,360,754,0.897619048
1521003,110,21,420,420,840,20,0,0.15,4.85,21,-61,801,740,0.880952381
1521003,110,21,420,420,840,20,0,0.15,5.85,24,89,659,748,0.89047619
1521004,110,21,420,420,840,20,0,0.15,4.75,20,145,567,712,0.847619048
1521004,110,21,420,420,840,20,0,0.15,5.75,20,27,673,700,0.833333333
1521005,110,21,420,420,840,20,0,0.0,5.0,21,143,591,734,0.873809524
1521005,110,21,420,420,840,20,0,0.0,6.0,20,191,593,784,0.933333333
1521006,110,21,420,420,840,20,0,0.0,4.75,21,186,500,686,0.816666667
1521006,110,21,420,420,840,20,0,0.0,5.75,19,154,506,660,0.785714286
1521007,110,21,420,420,840,20,0,0.0,5.0,23,574,196,770,0.916666667
1521007,110,21,420,420,840,20,0,0.0,6.0,23,626,160,786,0.935714286
1521008,103,10,284,190,474,9,0,0.0,5.0,10,218,210,428,0.902953586
1521008,110,11,260,260,520,10,0,0.0,5.4,11,149,337,486,0.934615385
1522001,112,13,260,416,676,10,1,0.0,2.0,10,167,363,530,0.784023669
1522002,112,13,260,416,676,10,1,0.0,2.0,11,373,229,602,0.890532544
1522003,112,13,260,416,676,10,1,0.2,1.8,9,116,426,542,0.801775148
1522004,112,13,260,416,676,10,1,0.1,1.9,9,-107,597,490,0.724852071
1522005,112,13,260,416,676,10,1,0.1,1.9,10,-25,591,566,0.837278107
1523001,112,13,260,416,676,10,1,0.0,2.0,12,159,467,626,0.926035503
1523002,112,13,260,416,676,10,1,0.0,2.0,13,320,343,663,0.980769231
1523003,112,13,260,416,676,10,1,0.0,2.0,11,321,177,498,0.736686391
1523004,112,13,260,416,676,10,1,0.3,1.7,13,513,117,630,0.931952663
1523005,112,13,260,416,676,10,1,0.3,1.7,13,89,537,626,0.926035503
1523006,112,13,260,416,676,10,1,0.0,2.0,10,324,269,593,0.877218935
1523007,112,13,260,416,676,10,1,0.2,1.8,13,382,244,626,0.926035503
1523008,112,13,260,416,676,10,1,0.1,1.9,10,465,125,590,0.872781065
1523009,112,13,260,416,676,10,1,0.1,1.8,12,460,177,637,0.942307692
1523010,112,13,260,416,676,10,1,0.1,1.9,12,367,255,622,0.920118343
1523011,112,13,260,416,676,10,1,0.1,1.9,14,357,315,672,0.99408284
1523012,112,13,260,416,676,10,1,0.0,2.0,11,229,361,590,0.872781065
1523013,112,13,260,416,676,10,1,0.0,2.0,11,272,346,618,0.914201183
1523014,112,13,260,416,676,10,1,0.0,2.0,14,205,459,664,0.982248521
1523015,112,13,260,416,676,10,1,0.2,1.8,13,412,214,626,0.926035503
1524001,105,12,276,330,606,25,0,0.0,2.64,6,5,267,272,0.448844884
1524002,100,1,50,50,100,3,0,0.0,3.0,1,30,70,100,1.0
1525001,112,13,260,416,676,10,1,0.0,2.0,15,246,414,660,0.976331361
1525002,112,13,260,416,676,10,1,0.0,2.0,14,176,483,659,0.974852071
1525003,112,13,260,416,676,10,1,0.0,2.0,15,331,329,660,0.976331361
1525004,112,13,260,416,676,10,1,0.0,2.0,13,233,427,660,0.976331361
1525005,112,13,260,416,676,10,1,0.0,2.0,15,221,439,660,0.976331361
1525007,112,13,260,416,676,10,1,0.0,2.0,13,-95,705,610,0.902366864
1527001,112,13,260,416,676,10,1,0.4,0.6,12,190,420,610,0.902366864
1527002,112,13,260,416,676,10,1,0.2,0.8,11,135,482,617,0.912721893
1527003,112,13,260,416,676,10,1,0.2,0.8,12,302,317,619,0.915680473
1527004,112,13,260,416,676,10,1,0.0,1.0,13,367,299,666,0.985207101
1527005,112,13,260,416,676,10,1,0.2,1.2,11,248,308,556,0.822485207
1528001,114,30,645,1050,1695,20,0,0.0,1.9,27,287,1262,1549,0.913864307
1528002,114,30,645,1050,1695,20,0,0.0,2.0,26,208,1379,1587,0.936283186
1528003,114,30,645,1050,1695,20,0,0.0,1.85,28,561,1075,1636,0.96519174
1528004,114,30,645,1050,1695,20,0,0.05,1.85,23,-150,1552,1402,0.827138643
1528005,114,30,645,1050,1695,20,0,0.1,1.55,26,880,666,1546,0.912094395
1529001,112,13,260,416,676,10,1,0.0,1.8,2,58,74,132,0.195266272
1529002,112,13,260,416,676,10,1,0.0,1.0,1,-80,161,81,0.119822485
1530001,107,15,330,435,765,11,0,0.0,3.909091,14,402,314,716,0.935947712
1530002,107,15,330,435,765,11,0,0.0,3.7272727,14,305,442,747,0.976470588
1531001,123,9,135,207,342,10,0,0.2,2.3,10,-40,333,293,0.856725146
1531002,123,9,135,207,342,10,0,1.0,2.0,10,304,-11,293,0.856725146
1531003,123,9,135,207,342,10,0,0.4,2.6,10,-91,404,313,0.915204678
1531004,123,9,135,207,342,10,0,0.7,2.2,10,196,98,294,0.859649123
1532001,100,3,75,75,150,2,0,0.0,2.0,3,118,32,150,1.0
1533001,100,25,650,650,1300,10,0,0.0,0.0,22,841,401,1242,0.955384615
1533002,100,25,650,650,1300,10,0,0.0,0.0,16,524,546,1070,0.823076923
1533003,100,25,650,650,1300,10,0,0.0,0.0,20,563,617,1180,0.907692308
1533004,90,5,200,156,356,3,0,0.0,0.0,5,174,180,354,0.994382022
1534001,118,14,602,497,1099,10,0,1.0,2.0,13,367,725,1092,0.993630573
1535001,99,33,924,909,1833,23,0,0.0,0.9130435,31,-8,1764,1756,0.957992362
1536001,65,13,780,390,1170,10,0,0.7,5.8,10,42,943,985,0.841880342
1536001,65,13,780,390,1170,10,0,0.7,6.8,6,-97,682,585,0.5
1536002,65,13,780,390,1170,10,0,0.3,6.4,9,2,938,940,0.803418803
1536002,65,13,780,390,1170,10,0,0.3,7.4,4,-478,978,500,0.427350427
1536003,65,13,780,390,1170,10,0,0.6,6.7,9,-211,1211,1000,0.854700855
1536003,65,13,780,390,1170,10,0,0.6,7.7,6,55,640,695,0.594017094
1537001,98,18,477,612,1089,28,0,0.0,1.0,25,448,371,819,0.752066116
1538001,110,24,660,888,1548,17,0,2.4117646,4.5882354,21,411,1000,1411,0.911498708
1538001,113,27,648,999,1647,18,0,2.2777777,5.5,22,683,776,1459,0.885853066
1539001,95,41,1029,962,1991,82,0,0.0,7.6463413,27,876,486,1362,0.684078353
1540001,112,13,260,416,676,10,1,0.0,0.9,9,34,510,544,0.804733728
1540002,112,13,260,416,676,10,1,0.1,0.7,7,69,387,456,0.674556213
1540003,112,13,260,416,676,10,1,0.2,0.7,10,280,316,596,0.881656805
1540004,112,13,260,416,676,10,1,0.0,0.8,10,69,472,541,0.800295858
1541001,345,6,195,465,660,8,0,0.75,1.25,7,285,305,590,0.893939394
1541002,345,6,195,465,660,8,0,0.375,1.5,10,-603,920,317,0.48030303
1541003,345,6,195,465,660,8,0,0.0,2.0,5,133,408,541,0.81969697
1542001,112,13,260,416,676,10,1,0.0,1.0,12,220,393,613,0.906804734
1542002,112,13,260,416,676,10,1,0.1,0.9,12,234,399,633,0.936390533
1542003,112,13,260,416,676,10,1,0.0,1.0,6,180,246,426,0.630177515
1542004,112,13,260,416,676,10,1,0.1,0.9,9,215,332,547,0.809171598
1542005,112,13,260,416,676,10,1,0.2,0.8,11,79,520,599,0.886094675
1542006,112,13,260,416,676,10,1,0.3,0.7,13,79,569,648,0.958579882
1542007,112,13,260,416,676,10,1,0.0,1.0,9,180,346,526,0.778106509
1542008,112,13,260,416,676,10,1,0.1,0.9,11,-46,658,612,0.905325444
1542009,112,13,260,416,676,10,1,0.1,0.9,8,10,436,446,0.659763314
1544001,112,13,260,416,676,10,1,0.0,0.0,10,82,491,573,0.847633136
1544002,112,9,180,288,468,6,0,0.0,0.0,6,74,292,366,0.782051282
1546001,112,13,260,416,676,10,1,0.3,2.7,9,272,257,529,0.782544379
1546001,112,13,260,416,676,10,1,0.3,3.7,13,267,403,670,0.99112426
1546001,112,13,260,416,676,10,1,0.3,4.7,12,269,382,651,0.963017751
1546002,112,13,260,416,676,10,1,0.3,2.7,6,149,203,352,0.520710059
1546002,112,13,260,416,676,10,1,0.3,3.7,11,267,310,577,0.853550296
1546002,112,13,260,416,676,10,1,0.3,4.7,9,180,331,511,0.75591716
1546003,112,13,260,416,676,10,1,0.0,3.0,5,223,116,339,0.50147929
1546003,112,13,260,416,676,10,1,0.0,4.0,12,270,376,646,0.955621302
1546003,112,13,260,416,676,10,1,0.0,5.0,13,192,463,655,0.968934911
1547001,112,13,260,416,676,10,1,2.1,6.9,13,301,375,676,1.0
1547001,112,13,260,416,676,10,1,2.1,7.9,13,277,389,666,0.985207101
1547002,112,13,260,416,676,10,1,2.3,7.3,13,331,312,643,0.951183432
1547002,112,13,260,416,676,10,1,2.3,8.3,10,205,293,498,0.736686391
1548001,101,25,613,696,1309,18,0,0.0,0.055555556,18,243,727,970,0.741023682
1548001,101,25,613,696,1309,18,0,0.0,1.0555556,23,661,553,1214,0.927425516
1548001,101,25,613,696,1309,18,0,0.0,2.0555556,22,596,571,1167,0.891520244
1548001,101,25,613,696,1309,18,0,0.0,3.0555556,20,644,470,1114,0.851031322
1548001,101,25,613,696,1309,18,0,0.0,4.0555553,21,724,504,1228,0.938120703
1549001,112,13,260,416,676,10,1,0.0,0.0,13,150,526,676,1.0
1549002,112,13,260,416,676,10,1,0.0,0.0,10,-390,981,591,0.874260355
1549003,112,13,260,416,676,10,1,0.0,0.0,13,303,341,644,0.952662722
1549004,112,13,260,416,676,10,1,0.0,0.0,11,219,385,604,0.893491124
1549005,112,13,260,416,676,10,1,0.0,0.0,13,461,194,655,0.968934911
1549006,112,13,260,416,676,10,1,0.0,0.0,9,28,464,492,0.727810651
1552001,500,32,8064,8064,16128,40,0,0.0,4.75,29,6404,5764,12168,0.754464286
1552002,500,32,8064,8064,16128,40,0,0.0,4.9,32,6316,6868,13184,0.817460317
1552003,500,32,8064,8064,16128,40,0,0.0,4.75,33,173,10203,10376,0.643353175
1552004,500,32,8064,8064,16128,40,0,0.0,4.95,33,3356,9660,13016,0.807043651
1552005,500,32,8064,8064,16128,40,0,0.0,4.15,18,1833,6871,8704,0.53968254
1553001,107,3,81,102,183,4,0,0.0,3.5,2,109,36,145,0.792349727
1553002,107,3,81,102,183,4,0,0.0,4.0,3,142,41,183,1.0
1553003,107,3,81,102,183,4,0,0.0,3.75,1,33,51,84,0.459016393
1553004,107,3,81,102,183,4,0,0.0,4.0,4,124,42,166,0.907103825
1553005,107,3,81,102,183,4,0,0.0,3.25,2,-1,93,92,0.50273224
1553006,107,3,81,102,183,4,0,0.0,3.75,1,1,60,61,0.333333333
1553007,107,3,81,102,183,4,0,0.0,3.0,3,99,84,183,1.0
1555001,110,21,420,630,1050,16,0,0.5625,5.75,23,487,528,1015,0.966666667
1555002,110,21,420,630,1050,16,0,0.375,6.0,21,342,645,987,0.94
1555003,110,21,420,630,1050,16,0,0.3125,6.375,21,646,323,969,0.922857143
1555004,110,21,420,630,1050,16,0,0.3125,7.0,24,560,460,1020,0.971428571
1555005,110,21,420,630,1050,16,0,0.5,5.5625,24,437,583,1020,0.971428571
1555006,110,21,420,630,1050,16,0,0.4375,6.125,24,376,644,1020,0.971428571
1555007,110,21,420,630,1050,16,0,0.0,6.0625,24,523,497,1020,0.971428571
1556001,108,210,4305,6211,10516,163,0,0.0,0.0,168,2407,5547,7954,0.756371244
1557001,112,9,180,288,468,6,0,0.0,0.0,8,34,420,454,0.97008547
1558001,112,13,260,416,676,10,1,0.1,0.9,12,259,378,637,0.942307692
1558001,112,13,260,416,676,10,1,0.1,1.9,13,374,290,664,0.982248521
1558002,112,13,260,416,676,10,1,0.3,0.7,9,359,169,528,0.781065089
1558002,112,13,260,416,676,10,1,0.3,1.7,11,337,267,604,0.893491124
1558004,112,13,260,416,676,10,1,0.2,0.7,10,273,300,573,0.847633136
1558004,112,13,260,416,676,10,1,0.2,1.7,12,313,315,628,0.928994083
1558005,112,13,260,416,676,10,1,0.1,0.9,12,154,494,648,0.958579882
1558005,112,13,260,416,676,10,1,0.1,1.9,14,193,473,666,0.985207101
1560001,99,50,1344,1356,2700,10,0,0.0,0.0,24,655,990,1645,0.609259259
1562001,110,51,1275,1275,2550,34,0,0.0,0.0,45,690,1681,2371,0.929803922
1562002,110,3,99,99,198,2,0,0.0,0.0,3,15,183,198,1.0
1563001,520,54,13041,13041,26082,20,0,0.0,2.55,62,7919,13387,21306,0.816885208
1563002,479,30,8340,7095,15435,11,0,0.0,3.909091,30,7710,3351,11061,0.716618076
1564001,112,13,260,416,676,10,1,0.3,4.7,9,423,126,549,0.812130178
1564002,112,13,260,416,676,10,1,0.5,4.2,7,100,364,464,0.686390533
1564003,112,13,260,416,676,10,1,0.4,4.6,7,291,203,494,0.730769231
1564004,112,13,260,416,676,10,1,0.5,4.4,8,399,96,495,0.732248521
1565001,110,21,420,630,1050,16,0,0.0,2.0,22,303,702,1005,0.957142857
1566001,94,12,342,264,606,9,0,3.0,10.444445,2,148,17,165,0.272277228
1568001,134,45,6030,3060,9090,32,0,0.125,7.875,46,5234,2999,8233,0.905720572
1568001,134,45,6030,3060,9090,32,0,0.125,8.875,46,6577,2013,8590,0.944994499
1568001,134,45,6030,3060,9090,32,0,0.125,9.875,50,6268,2311,8579,0.943784378
1568001,134,45,6030,3060,9090,32,0,0.125,10.875,48,5811,3033,8844,0.972937294
1569001,78,13,312,156,468,10,0,0.9,8.3,11,22,352,374,0.799145299
1569001,78,13,312,156,468,10,0,0.9,9.3,11,95,319,414,0.884615385
1569002,78,13,312,156,468,10,0,1.0,10.1,7,106,196,302,0.645299145
1569002,78,13,312,156,468,10,0,1.0,11.1,6,24,282,306,0.653846154
1569003,78,13,312,156,468,10,0,0.0,11.4,7,94,284,378,0.807692308
1569003,78,13,312,156,468,10,0,0.0,12.4,5,48,246,294,0.628205128
1569004,78,13,312,156,468,10,0,0.4,11.0,8,70,274,344,0.735042735
1569004,78,13,312,156,468,10,0,0.4,12.0,5,55,191,246,0.525641026
1571001,136,3,33,96,129,11,0,0.09090909,1.0,6,-920,821,-99,-0.76744186
1571001,136,3,33,96,129,11,0,0.09090909,2.0,2,-4,36,32,0.248062016
1572001,110,13,234,390,624,10,0,0.0,2.0,12,119,448,567,0.908653846
1572002,110,13,234,390,624,10,0,0.2,1.8,11,271,263,534,0.855769231
1573001,116,34,595,1122,1717,14,0,1.0714285,5.785714,28,1185,404,1589,0.925451369
1573001,116,34,595,1122,1717,14,0,1.0714285,6.785714,29,918,686,1604,0.934187536
1574001,115,48,1272,1272,2544,24,0,0.0,4.6666665,39,1429,872,2301,0.904481132
1575001,112,13,260,416,676,10,1,0.0,3.0,11,326,260,586,0.866863905
1575002,112,13,260,416,676,10,1,0.0,2.8,14,376,275,651,0.963017751
1575003,112,13,260,416,676,10,1,0.4,2.9,14,-161,812,651,0.963017751
1575004,112,13,260,416,676,10,1,0.0,2.6,15,512,148,660,0.976331361
1575005,112,13,260,416,676,10,1,0.3,3.7,11,197,402,599,0.886094675
1576001,100,50,1275,1275,2550,10,0,0.0,3.4,31,2024,-82,1952,0.765490196
1576002,92,20,700,536,1236,5,0,0.0,3.6,12,906,-70,836,0.676375405
1578001,108,642,13506,18625,32131,312,0,0.0,2.9519231,441,18337,4275,22642,0.704677726
1579001,112,13,260,416,676,10,1,4.0,2.5,12,417,238,655,0.968934911
1579003,111,6,135,201,336,4,0,3.25,2.75,6,40,296,336,1.0
1580001,108,252,5418,7652,13070,60,0,0.0,2.9166667,209,5699,5387,11086,0.848201989
1580001,108,252,5418,7652,13070,60,0,0.0,3.9166667,214,5683,5606,11289,0.863733741
1580002,108,252,5418,7652,13070,60,0,0.0,2.8666666,181,5990,4442,10432,0.798163734
1580002,108,252,5418,7652,13070,60,0,0.0,3.8666666,196,7341,3673,11014,0.842693191
1580003,108,252,5418,7652,13070,60,0,0.0,2.9666667,211,6128,5009,11137,0.852104055
1580003,108,252,5418,7652,13070,60,0,0.0,3.9666667,211,6129,4711,10840,0.82938026
1580004,108,252,5418,7652,13070,60,0,0.0,3.1,167,7803,2489,10292,0.787452181
1580004,108,252,5418,7652,13070,60,0,0.0,4.1,199,6045,4880,10925,0.835883703
1580005,108,252,5418,7652,13070,60,0,0.0,3.1,189,3890,6479,10369,0.793343535
1580005,108,252,5418,7652,13070,60,0,0.0,4.1,186,7578,3170,10748,0.822341239
1580006,109,139,2937,4434,7371,34,0,0.0,2.8823528,86,2713,2543,5256,0.713064713
1580006,109,157,3277,4993,8270,38,0,0.0,3.7368422,124,5873,1103,6976,0.843530834
1581001,101,50,1225,1276,2501,34,0,0.0,0.0,48,1201,1249,2450,0.979608157
1581001,101,50,1225,1276,2501,34,0,0.0,1.0,48,911,1526,2437,0.974410236
1581001,101,50,1225,1276,2501,34,0,0.0,2.0,51,1090,1409,2499,0.99920032
1581001,101,50,1225,1276,2501,34,0,0.0,3.0,23,698,690,1388,0.554978009
1583001,98,26,935,652,1587,18,0,0.0,2.0,23,534,964,1498,0.943919345
1586001,112,9,180,288,468,6,0,0.0,1.0,5,-20,342,322,0.688034188
1588001,100,25,650,650,1300,10,0,0.0,5.3,18,456,684,1140,0.876923077
1588001,100,25,650,650,1300,10,0,0.0,6.3,18,513,619,1132,0.870769231
1588001,100,25,650,650,1300,10,0,0.0,7.3,4,146,178,324,0.249230769
1590006,112,13,260,416,676,10,1,0.2,2.8,9,265,311,576,0.852071006
1591001,100,8,204,204,408,10,0,0.8,5.2,7,265,141,406,0.995098039
1591002,100,8,204,204,408,10,0,1.8,4.0,7,152,233,385,0.943627451
1593001,100,3,90,90,180,2,0,0.0,0.0,3,73,107,180,1.0
1594001,550,6,1545,1545,3090,20,0,0.2,2.8,6,1147,1096,2243,0.725889968
1594002,550,6,1545,1545,3090,20,0,0.2,2.7,7,2159,445,2604,0.842718447
1594003,550,6,1545,1545,3090,20,0,0.1,2.95,8,1960,466,2426,0.785113269
1594004,550,6,1545,1545,3090,20,0,0.1,3.0,7,1068,1305,2373,0.767961165
1594005,550,6,1545,1545,3090,20,0,0.1,2.9,7,2192,104,2296,0.743042071
1594006,550,6,1545,1545,3090,20,0,0.0,2.9,9,1394,777,2171,0.702588997
1594007,550,6,1545,1545,3090,20,0,0.4,2.8,7,864,1278,2142,0.693203883
1594008,550,6,1545,1545,3090,20,0,0.3,3.05,8,2002,732,2734,0.884789644
1594009,550,6,1545,1545,3090,20,0,0.4,2.6,6,2336,754,3090,1.0
1594010,550,6,1545,1545,3090,20,0,0.1,2.9,3,948,520,1468,0.475080906
1596001,96,10,155,235,390,10,0,0.1,2.3,12,-11,251,240,0.615384615
1596001,96,10,155,235,390,10,0,0.1,3.4,9,-16,319,303,0.776923077
1596002,96,10,155,235,390,10,0,0.3,1.7,9,44,319,363,0.930769231
1596002,96,10,155,235,390,10,0,0.3,2.7,4,93,85,178,0.456410256
1596003,96,10,155,235,390,10,0,0.3,1.7,8,132,163,295,0.756410256
1596003,96,10,155,235,390,10,0,0.3,2.7,5,89,121,210,0.538461538
1596004,96,10,155,235,390,10,0,0.3,1.7,10,-48,360,312,0.8
1596004,96,10,155,235,390,10,0,0.3,2.7,8,148,228,376,0.964102564
1596005,96,10,155,235,390,10,0,0.4,1.6,9,148,164,312,0.8
1596005,96,10,155,235,390,10,0,0.4,2.6,6,146,100,246,0.630769231
1597001,106,267,5849,7590,13439,205,0,0.0,1.0,188,4131,5375,9506,0.707344296
1599001,100,16,240,240,480,20,0,0.0,0.0,18,295,99,394,0.820833333
1599001,100,16,240,240,480,20,0,0.0,1.0,19,162,202,364,0.758333333
1599001,100,16,240,240,480,20,0,0.0,2.0,16,185,193,378,0.7875
1599001,100,16,240,240,480,20,0,0.0,3.0,12,200,168,368,0.766666667
1599002,100,16,240,240,480,20,0,0.0,0.0,20,44,268,312,0.65
1599002,100,16,240,240,480,20,0,0.0,1.0,20,222,88,310,0.645833333
1599002,100,16,240,240,480,20,0,0.0,2.0,17,264,154,418,0.870833333
1599002,100,16,240,240,480,20,0,0.0,3.0,15,228,214,442,0.920833333
1599003,100,16,240,240,480,20,0,0.0,0.0,15,224,152,376,0.783333333
1599003,100,16,240,240,480,20,0,0.0,1.0,17,184,180,364,0.758333333
1599003,100,16,240,240,480,20,0,0.0,2.0,17,181,193,374,0.779166667
1599003,100,16,240,240,480,20,0,0.0,3.0,12,186,176,362,0.754166667
1599004,100,16,240,240,480,20,0,0.0,0.0,17,302,32,334,0.695833333
1599004,100,16,240,240,480,20,0,0.0,1.0,23,74,236,310,0.645833333
1599004,100,16,240,240,480,20,0,0.0,2.0,23,213,71,284,0.591666667
1599004,100,16,240,240,480,20,0,0.0,3.0,17,148,234,382,0.795833333
1599006,100,16,240,240,480,20,0,0.0,0.0,24,30,214,244,0.508333333
1599006,100,16,240,240,480,20,0,0.0,1.0,19,122,242,364,0.758333333
1599006,100,16,240,240,480,20,0,0.0,2.0,23,120,200,320,0.666666667
1599006,100,16,240,240,480,20,0,0.0,3.0,18,142,202,344,0.716666667
1599007,100,16,240,240,480,20,0,0.0,0.0,21,-615,859,244,0.508333333
1599007,100,16,240,240,480,20,0,0.0,1.0,17,-49,385,336,0.7
1599007,100,16,240,240,480,20,0,0.0,2.0,17,-36,388,352,0.733333333
1599007,100,16,240,240,480,20,0,0.0,3.0,15,-28,412,384,0.8
1599008,100,16,240,240,480,20,0,0.0,0.0,22,277,37,314,0.654166667
1599008,100,16,240,240,480,20,0,0.0,1.0,18,145,183,328,0.683333333
1599008,100,16,240,240,480,20,0,0.0,2.0,21,209,143,352,0.733333333
1599008,100,16,240,240,480,20,0,0.0,3.0,15,196,208,404,0.841666667
1599009,100,16,240,240,480,20,0,0.0,0.0,22,-209,503,294,0.6125
1599009,100,16,240,240,480,20,0,0.0,1.0,21,201,93,294,0.6125
1599009,100,16,240,240,480,20,0,0.0,2.0,17,-25,265,240,0.5
1599009,100,16,240,240,480,20,0,0.0,3.0,19,-21,285,264,0.55
1599010,100,16,240,240,480,20,0,0.0,0.0,18,139,267,406,0.845833333
1599010,100,16,240,240,480,20,0,0.0,1.0,21,121,249,370,0.770833333
1599010,100,16,240,240,480,20,0,0.0,2.0,17,170,234,404,0.841666667
1599010,100,16,240,240,480,20,0,0.0,3.0,15,70,276,346,0.720833333
1599011,100,16,240,240,480,20,0,0.0,0.0,18,125,257,382,0.795833333
1599011,100,16,240,240,480,20,0,0.0,1.0,18,228,122,350,0.729166667
1599011,100,16,240,240,480,20,0,0.0,2.0,18,321,1,322,0.670833333
1599011,100,16,240,240,480,20,0,0.0,3.0,13,190,196,386,0.804166667
1599012,100,16,240,240,480,20,0,0.0,0.0,22,-271,563,292,0.608333333
1599012,100,16,240,240,480,20,0,0.0,1.0,21,121,165,286,0.595833333
1599012,100,16,240,240,480,20,0,0.0,2.0,11,-5,253,248,0.516666667
1599012,100,16,240,240,480,20,0,0.0,3.0,10,106,150,256,0.533333333
1599014,99,10,170,168,338,11,0,0.36363637,0.0,6,242,-94,148,0.437869822
1599015,90,3,60,38,98,3,0,0.0,0.0,1,43,17,60,0.612244898
1599015,100,8,136,136,272,8,0,0.0,1.375,8,91,77,168,0.617647059
1600001,112,13,260,416,676,10,1,0.0,0.0,15,-190,850,660,0.976331361
1600001,112,13,260,416,676,10,1,0.0,1.0,5,41,251,292,0.431952663
1600002,112,13,260,416,676,10,1,0.0,0.0,14,268,389,657,0.971893491
1600003,112,13,260,416,676,10,1,0.0,0.0,12,698,-74,624,0.923076923
1600004,108,12,270,366,636,9,0,0.0,0.0,12,297,319,616,0.968553459
1604001,107,15,330,435,765,14,0,0.5714286,1.4285715,14,274,438,712,0.930718954
1604002,107,15,330,435,765,14,0,0.71428573,1.2857143,11,469,163,632,0.826143791
1605001,110,65,1504,2064,3568,50,0,0.0,3.0,60,1253,1921,3174,0.889573991
1605002,110,65,1504,2064,3568,50,0,0.0,2.92,54,1295,1533,2828,0.792600897
1605003,110,65,1504,2064,3568,50,0,0.0,2.92,51,1476,1362,2838,0.795403587
1605004,110,59,1399,1853,3252,45,0,0.0,2.7777777,44,858,1573,2431,0.747539975
1606001,108,9,198,270,468,21,0,0.0,2.0,9,29,439,468,1.0
1607001,112,13,260,416,676,10,1,0.0,3.6,10,364,207,571,0.844674556
1607002,112,13,260,416,676,10,1,0.0,4.0,13,-310,958,648,0.958579882
1607003,112,13,260,416,676,10,1,0.0,3.8,11,466,174,640,0.946745562
1607004,112,13,260,416,676,10,1,0.0,3.9,13,662,0,662,0.979289941
1607005,112,13,260,416,676,10,1,0.0,3.6,9,265,248,513,0.75887574
1607006,112,13,260,416,676,10,1,0.0,3.2,11,291,240,531,0.785502959
1607007,112,13,260,416,676,10,1,0.0,3.9,9,201,389,590,0.872781065
1607008,112,13,260,416,676,10,1,0.0,3.2,9,271,278,549,0.812130178
1607009,112,13,260,416,676,10,1,0.0,4.0,11,184,447,631,0.933431953
1607010,112,13,260,416,676,10,1,0.0,4.0,11,509,101,610,0.902366864
1607011,112,13,260,416,676,10,1,0.0,4.0,13,495,167,662,0.979289941
1607012,112,11,223,357,580,8,0,0.0,3.5,6,91,318,409,0.705172414
1608001,110,3,75,105,180,2,0,0.0,1.0,3,1,179,180,1.0
1609001,112,13,260,416,676,10,1,0.0,4.0,10,207,373,580,0.857988166
1609002,112,13,260,416,676,10,1,0.0,4.0,11,401,246,647,0.957100592
1609003,112,13,260,416,676,10,1,0.0,3.7,10,385,231,616,0.911242604
1609004,112,9,180,288,468,6,0,0.0,4.0,7,163,267,430,0.918803419
1610001,112,13,429,416,845,10,0,0.7,4.3,11,117,693,810,0.958579882
1610001,112,13,429,416,845,10,0,1.0,8.0,12,398,437,835,0.98816568
1610001,112,13,429,416,845,10,0,1.0,9.0,13,130,675,805,0.952662722
1610002,112,13,429,416,845,10,0,0.1,4.8,13,195,635,830,0.982248521
1610002,112,13,429,416,845,10,0,0.1,8.8,13,433,412,845,1.0
1610002,112,13,429,416,845,10,0,0.1,9.8,13,137,668,805,0.952662722
1610003,112,13,429,416,845,10,0,0.6,4.3,12,461,364,825,0.976331361
1610003,112,13,429,416,845,10,0,1.2,7.7,12,331,489,820,0.970414201
1610003,112,13,429,416,845,10,0,1.2,8.7,10,267,458,725,0.857988166
1613001,129,150,9229,9175,18404,59,0,0.0,6.9322033,184,8233,3026,11259,0.611769181
1617001,96,10,155,235,390,10,0,0.3,2.2,11,88,261,349,0.894871795
1617001,96,10,155,235,390,10,0,0.3,3.2,10,115,261,376,0.964102564
1617002,96,10,155,235,390,10,0,0.3,1.7,8,167,174,341,0.874358974
1617002,96,10,155,235,390,10,0,0.3,2.7,10,124,257,381,0.976923077
1617003,96,10,155,235,390,10,0,0.5,1.5,7,42,298,340,0.871794872
1617003,96,10,155,235,390,10,0,0.5,2.5,10,104,275,379,0.971794872
1617004,96,10,155,235,390,10,0,0.2,1.8,9,140,224,364,0.933333333
1617004,96,10,155,235,390,10,0,0.2,2.8,9,144,226,370,0.948717949
1617005,96,10,155,235,390,10,0,0.2,1.8,9,97,244,341,0.874358974
1617005,96,10,155,235,390,10,0,0.2,2.8,10,130,217,347,0.88974359
1618001,494,4,1128,904,2032,5,0,0.0,1.0,6,-1856,3000,1144,0.562992126
1619001,125,9,117,117,234,10,0,0.3,1.7,9,55,116,171,0.730769231
1619002,125,9,117,117,234,10,0,0.1,1.9,12,-26,209,183,0.782051282
1619003,125,9,117,117,234,10,0,0.5,1.5,13,176,-6,170,0.726495726
1619004,125,9,117,117,234,10,0,0.2,1.8,10,119,54,173,0.739316239
1619005,125,9,117,117,234,10,0,0.1,1.9,12,105,90,195,0.833333333
1620001,118,9,144,216,360,8,0,0.0,0.0,7,199,75,274,0.761111111
1620002,118,9,144,216,360,8,0,0.0,0.0,7,67,249,316,0.877777778
1620003,118,9,144,216,360,8,0,0.0,0.125,7,94,236,330,0.916666667
1621001,112,13,260,416,676,10,1,0.0,0.0,11,94,555,649,0.960059172
1621002,112,13,260,416,676,10,1,0.0,0.0,13,228,409,637,0.942307692
1623001,108,9,198,270,468,10,0,2.4,14.4,5,205,151,356,0.760683761
1623001,108,9,198,270,468,10,0,2.4,15.4,7,238,180,418,0.893162393
1623002,108,9,198,270,468,10,0,1.5,16.5,6,263,129,392,0.837606838
1623002,108,9,198,270,468,10,0,1.5,17.5,6,258,59,317,0.677350427
1624001,110,13,234,390,624,10,0,0.1,0.0,13,163,438,601,0.963141026
1624002,110,13,234,390,624,10,0,0.3,0.6,12,246,331,577,0.924679487
1624003,110,13,234,390,624,10,0,0.0,0.0,13,332,256,588,0.942307692
1624004,110,13,234,390,624,10,0,0.0,0.0,13,72,525,597,0.956730769
1624005,110,13,234,390,624,10,0,0.0,0.0,9,41,461,502,0.804487179
1625001,112,13,260,416,676,10,1,0.0,1.0,14,571,80,651,0.963017751
1625002,112,13,260,416,676,10,1,0.0,1.0,15,88,572,660,0.976331361
1626001,112,13,260,416,676,10,1,0.0,0.0,10,-115,700,585,0.865384615
1626002,112,13,260,416,676,10,1,0.0,0.0,11,31,576,607,0.897928994
1626003,112,13,260,416,676,10,1,0.0,0.0,14,-227,873,646,0.955621302
1626004,112,13,260,416,676,10,1,0.0,0.0,13,422,231,653,0.965976331
1626005,112,13,260,416,676,10,1,0.0,0.0,13,168,436,604,0.893491124
1627001,112,13,260,416,676,10,1,0.0,2.5,11,263,374,637,0.942307692
1628001,114,30,645,1050,1695,13,0,0.0,10.0,27,549,974,1523,0.898525074
1628001,114,30,645,1050,1695,13,0,0.0,11.0,23,465,776,1241,0.732153392
1628001,114,30,645,1050,1695,13,0,0.0,12.0,23,452,890,1342,0.791740413
1629001,123,19,1216,703,1919,15,0,0.0,6.0,19,814,1054,1868,0.973423658
1629001,123,19,1216,703,1919,15,0,0.0,7.0,20,1021,843,1864,0.971339239
1630001,112,13,260,416,676,10,1,0.0,0.0,10,376,213,589,0.871301775
1630001,112,13,260,416,676,10,1,0.0,1.0,12,389,236,625,0.924556213
1630002,112,13,260,416,676,10,1,0.0,0.0,13,472,178,650,0.961538462
1630002,112,13,260,416,676,10,1,0.0,1.0,12,366,252,618,0.914201183
1630003,112,13,260,416,676,10,1,0.0,0.0,13,298,346,644,0.952662722
1630003,112,13,260,416,676,10,1,0.0,1.0,12,149,517,666,0.985207101
1630004,112,13,260,416,676,10,1,0.0,0.0,14,305,361,666,0.985207101
1630004,112,13,260,416,676,10,1,0.0,1.0,14,161,511,672,0.99408284
1632001,107,15,330,435,765,11,0,0.36363637,3.6363637,6,287,121,423,0.552941176
1633010,116,23,506,759,1265,16,0,0.125,4.5,7,208,139,347,0.2743083
1633010,116,23,506,759,1265,16,0,0.125,5.5,7,218,129,347,0.2743083
1633011,116,23,506,759,1265,16,0,0.0,5.4375,19,364,769,1133,0.895652174
1633011,116,23,506,759,1265,16,0,0.0,6.4375,23,281,975,1256,0.992885375
1633012,116,23,506,759,1265,16,0,0.0625,5.5625,19,629,572,1201,0.949407115
1633012,116,23,506,759,1265,16,0,0.0625,6.5625,22,480,771,1251,0.988932806
1633013,116,23,506,759,1265,16,0,0.1875,5.5,15,212,682,894,0.706719368
1633013,116,23,506,759,1265,16,0,0.1875,6.5,15,404,488,892,0.70513834
1633014,116,23,506,759,1265,16,0,0.125,5.625,19,519,618,1137,0.898814229
1633014,116,23,506,759,1265,16,0,0.125,6.625,20,600,631,1231,0.97312253
1633015,116,23,506,759,1265,16,0,0.125,5.3125,18,703,387,1090,0.861660079
1633015,116,23,506,759,1265,16,0,0.125,6.3125,21,609,630,1239,0.97944664
1633016,116,23,506,759,1265,16,0,0.0,5.75,22,359,861,1220,0.964426877
1633016,116,23,506,759,1265,16,0,0.0,6.75,19,371,685,1056,0.834782609
1633017,116,23,506,759,1265,16,0,0.3125,5.0625,20,391,836,1227,0.969960474
1633017,116,23,506,759,1265,16,0,0.3125,6.0625,14,518,418,936,0.739920949
1633018,116,23,506,759,1265,16,0,0.1875,5.125,19,796,373,1169,0.924110672
1633018,116,23,506,759,1265,16,0,0.1875,6.125,20,899,321,1220,0.964426877
1633019,116,23,506,759,1265,16,0,0.25,5.25,21,634,580,1214,0.959683794
1633019,116,23,506,759,1265,16,0,0.25,6.25,20,736,423,1159,0.916205534
1633020,114,9,252,333,585,6,0,0.0,5.1666665,7,166,354,520,0.888888889
1637001,90,6,195,135,330,10,0,0.7,17.1,4,98,187,285,0.863636364
1637001,90,6,195,135,330,10,0,0.7,18.1,4,102,169,271,0.821212121
1637002,90,6,195,135,330,10,0,1.8,16.1,4,96,196,292,0.884848485
1637002,90,6,195,135,330,10,0,1.8,17.1,4,74,185,259,0.784848485
1637003,90,6,195,135,330,10,0,1.2,17.3,4,94,198,292,0.884848485
1637003,90,6,195,135,330,10,0,1.2,18.3,4,27,237,264,0.8
1638001,114,30,645,1050,1695,21,0,0.0,0.95238096,30,1216,449,1665,0.982300885
1639001,120,26,650,650,1300,20,0,0.3,6.7,17,612,466,1078,0.829230769
1639001,120,26,650,650,1300,20,0,0.3,7.7,17,715,343,1058,0.813846154
1639002,120,26,650,650,1300,20,0,0.15,6.85,18,855,275,1130,0.869230769
1639002,120,26,650,650,1300,20,0,0.15,7.85,16,782,288,1070,0.823076923
1639003,120,26,650,650,1300,20,0,0.0,7.0,16,564,452,1016,0.781538462
1639003,120,26,650,650,1300,20,0,0.0,8.0,16,634,390,1024,0.787692308
1639004,120,26,650,650,1300,20,0,0.0,6.85,19,499,669,1168,0.898461538
1639004,120,26,650,650,1300,20,0,0.0,7.85,22,748,446,1194,0.918461538
1639005,120,26,650,650,1300,20,0,0.0,7.0,19,608,474,1082,0.832307692
1639005,120,26,650,650,1300,20,0,0.0,8.0,19,776,386,1162,0.893846154
1639006,120,26,650,650,1300,20,0,0.3,6.7,13,655,201,856,0.658461538
1639006,120,26,650,650,1300,20,0,0.3,7.7,16,780,294,1074,0.826153846
1639007,120,26,650,650,1300,20,0,0.0,6.8,17,730,330,1060,0.815384615
1639007,120,26,650,650,1300,20,0,0.0,7.8,19,771,291,1062,0.816923077
1639008,120,12,324,324,648,8,0,0.0,5.875,7,268,250,518,0.799382716
1639008,120,12,324,324,648,8,0,0.0,6.875,8,376,190,566,0.87345679
1640001,140,9,900,600,1500,7,0,4.428571,1.0,9,349,1111,1460,0.973333333
1641001,128,112,6928,6759,13687,41,0,0.0,9.780488,96,3447,5915,9362,0.684006722
1642001,550,6,1545,1545,3090,20,0,0.1,4.05,7,1165,1208,2373,0.767961165
1642002,550,6,1545,1545,3090,20,0,0.0,3.85,5,1201,1528,2729,0.883171521
1642003,550,6,1545,1545,3090,20,0,0.1,3.8,6,937,1229,2166,0.700970874
1642004,550,6,1545,1545,3090,20,0,0.0,3.9,7,1090,1514,2604,0.842718447
1642005,550,6,1545,1545,3090,20,0,0.05,4.1,5,215,2129,2344,0.758576052
1642006,550,6,1545,1545,3090,20,0,0.2,3.55,7,608,1534,2142,0.693203883
1642007,550,6,1545,1545,3090,20,0,0.0,3.65,5,1108,1544,2652,0.858252427
1642008,550,6,1545,1545,3090,20,0,0.3,3.8,6,948,1449,2397,0.775728155
1642009,550,6,1545,1545,3090,20,0,0.4,3.4,9,-639,2887,2248,0.727508091
1642010,550,6,1545,1545,3090,20,0,0.3,4.1,6,605,1330,1935,0.626213592
1643001,112,13,260,416,676,10,1,0.0,0.0,8,-134,586,452,0.668639053
1644001,105,12,276,330,606,9,0,0.0,1.0,12,161,420,581,0.958745875
1644002,105,12,276,330,606,9,0,0.0,1.0,12,427,144,571,0.942244224
1644003,105,12,276,330,606,9,0,0.0,1.0,12,246,360,606,1.0
1646001,90,3,86,91,177,2,0,0.0,3.0,3,95,82,177,1.0
1647001,112,13,260,416,676,10,1,0.2,0.9,10,99,444,543,0.803254438
1647002,112,13,260,416,676,10,1,0.1,0.9,14,86,560,646,0.955621302
1647003,112,13,260,416,676,10,1,0.0,1.0,11,447,202,649,0.960059172
1647004,112,13,260,416,676,10,1,0.1,0.9,12,106,515,621,0.918639053
1647005,112,13,260,416,676,10,1,0.2,0.8,10,53,467,520,0.769230769
1647006,112,13,260,416,676,10,1,0.4,0.6,10,64,500,564,0.834319527
1648001,114,30,645,1050,1695,20,0,0.0,0.0,23,775,670,1445,0.852507375
1648002,114,30,645,1050,1695,20,0,0.0,0.0,23,515,985,1500,0.884955752
1648003,114,30,645,1050,1695,20,0,0.0,0.0,19,213,1032,1245,0.734513274
1648004,114,30,645,1050,1695,20,0,0.0,0.0,22,321,1097,1418,0.836578171
1648005,114,30,645,1050,1695,20,0,0.0,0.0,23,815,618,1433,0.845427729
1648006,114,30,645,1050,1695,20,0,0.0,0.05,17,285,820,1105,0.651917404
1648007,114,30,645,1050,1695,20,0,0.0,0.0,20,505,769,1274,0.751622419
1648008,114,30,645,1050,1695,20,0,0.0,0.0,15,198,847,1045,0.616519174
1648009,114,30,645,1050,1695,20,0,0.0,0.15,20,568,725,1293,0.762831858
1648010,114,30,645,1050,1695,20,0,0.0,0.0,20,342,957,1299,0.766371681
1648011,114,30,645,1050,1695,20,0,0.0,0.0,17,422,732,1154,0.680825959
1648012,114,30,645,1050,1695,20,0,0.0,0.0,24,187,1183,1370,0.808259587
1649001,95,10,135,225,360,10,0,0.0,2.0,9,221,73,294,0.816666667
1649001,95,10,135,225,360,10,0,0.0,3.0,11,12,304,316,0.877777778
1649002,95,10,135,225,360,10,0,0.0,1.9,11,88,190,278,0.772222222
1649002,95,10,135,225,360,10,0,0.0,2.9,10,179,133,312,0.866666667
1649003,95,10,135,225,360,10,0,0.0,2.0,11,8,277,285,0.791666667
1649003,95,10,135,225,360,10,0,0.0,3.0,11,57,235,292,0.811111111
1649004,95,10,135,225,360,10,0,0.1,1.9,9,106,238,344,0.955555556
1649004,95,10,135,225,360,10,0,0.1,2.9,9,203,110,313,0.869444444
1650001,100,16,440,440,880,32,0,0.0,7.28125,11,57,572,629,0.714772727
1651001,96,10,155,235,390,10,0,0.3,0.7,10,72,264,336,0.861538462
1651001,96,10,155,235,390,10,0,0.3,1.7,9,172,189,361,0.925641026
1651002,96,10,155,235,390,10,0,0.4,0.5,10,89,244,333,0.853846154
1651002,96,10,155,235,390,10,0,0.4,1.5,11,167,199,366,0.938461538
1651003,96,10,155,235,390,10,0,0.1,1.9,10,-62,441,379,0.971794872
1651003,96,10,155,235,390,10,0,0.1,2.9,7,88,195,283,0.725641026
1652001,125,19,532,532,1064,14,0,0.0,0.0,21,767,283,1050,0.986842105
1654001,112,3,78,114,192,2,0,0.0,0.0,3,153,39,192,1.0
1654001,112,3,78,114,192,2,0,0.0,1.0,3,97,95,192,1.0
1655001,78,13,312,156,468,10,0,1.8,10.0,9,296,56,352,0.752136752
1655001,78,13,312,156,468,10,0,1.8,11.0,9,300,72,372,0.794871795
1655002,78,13,312,156,468,10,0,2.5,8.5,11,286,138,424,0.905982906
1655002,78,13,312,156,468,10,0,2.5,9.5,12,284,170,454,0.97008547
1657001,95,5,147,125,272,11,0,0.0,0.0,3,113,7,120,0.441176471
1658001,112,13,260,416,676,10,1,0.0,0.0,13,267,393,660,0.976331361
1658001,112,13,260,416,676,10,1,0.0,1.0,12,281,326,607,0.897928994
1658002,112,13,260,416,676,10,1,0.0,0.0,13,350,326,676,1.0
1658002,112,13,260,416,676,10,1,0.0,1.0,12,344,325,669,0.98964497
1658003,112,13,260,416,676,10,1,0.0,0.0,14,459,213,672,0.99408284
1658003,112,13,260,416,676,10,1,0.0,1.0,9,235,225,460,0.680473373
1661001,65,13,780,390,1170,10,0,0.2,5.8,7,150,775,925,0.790598291
1661001,65,13,780,390,1170,10,0,0.2,6.8,11,107,968,1075,0.918803419
1661002,65,13,780,390,1170,10,0,0.6,5.0,9,607,408,1015,0.867521368
1661002,65,13,780,390,1170,10,0,0.6,6.0,8,91,859,950,0.811965812
1661003,65,13,780,390,1170,10,0,0.2,5.8,6,360,395,755,0.645299145
1661003,65,13,780,390,1170,10,0,0.2,6.8,4,209,336,545,0.465811966
1664001,110,21,420,420,840,20,0,1.45,4.05,16,250,444,694,0.826190476
1664001,110,21,420,420,840,20,0,1.45,5.05,21,273,487,760,0.904761905
1664002,103,10,284,190,474,9,0,0.7777778,2.8888888,8,141,185,326,0.687763713
1664002,103,10,284,190,474,9,0,0.7777778,3.8888888,10,477,-21,456,0.962025316
1667001,96,10,155,235,390,10,0,0.2,1.9,12,143,197,340,0.871794872
1667001,96,10,155,235,390,10,0,0.2,2.9,10,14,289,303,0.776923077
1667002,96,10,155,235,390,10,0,0.0,2.0,10,11,336,347,0.88974359
1667002,96,10,155,235,390,10,0,0.0,3.0,8,6,224,230,0.58974359
1667003,96,10,155,235,390,10,0,0.0,2.0,13,194,154,348,0.892307692
1667003,96,10,155,235,390,10,0,0.0,3.0,11,278,98,376,0.964102564
1667004,96,10,155,235,390,10,0,0.1,1.9,9,154,193,347,0.88974359
1667004,96,10,155,235,390,10,0,0.1,2.9,12,128,234,362,0.928205128
1667005,96,10,155,235,390,10,0,0.3,2.3,10,207,100,307,0.787179487
1667005,96,10,155,235,390,10,0,0.3,3.3,9,175,154,329,0.843589744
1667006,93,4,92,112,204,4,0,1.25,1.0,3,124,45,169,0.828431373
1668001,120,11,165,275,440,10,0,0.2,2.4,8,206,188,394,0.895454545
1668002,120,11,165,275,440,10,0,0.0,3.0,8,252,146,398,0.904545455
1668003,120,11,165,275,440,10,0,0.0,3.0,8,118,238,356,0.809090909
1668004,120,11,165,275,440,10,0,0.0,3.0,9,275,69,344,0.781818182
1668005,120,11,165,275,440,10,0,0.2,2.8,10,-36,422,386,0.877272727
1668007,120,11,165,275,440,10,0,0.2,3.2,10,250,182,432,0.981818182
1668009,120,11,165,275,440,10,0,0.2,3.7,9,110,275,385,0.875
1668010,120,3,45,75,120,2,0,0.0,3.0,2,58,62,120,1.0
1670001,112,13,260,416,676,10,1,0.2,1.8,11,342,270,612,0.905325444
1670002,112,13,260,416,676,10,1,0.6,1.4,13,165,489,654,0.967455621
1670003,112,13,260,416,676,10,1,0.4,1.6,13,411,247,658,0.973372781
1670004,112,13,260,416,676,10,1,0.0,2.0,9,310,154,464,0.686390533
1672001,130,61,3660,3660,7320,20,0,0.0,0.0,82,2349,2593,4942,0.675136612
1672002,90,9,720,392,1112,3,0,0.0,0.0,2,19,439,458,0.411870504
1673001,90,11,385,165,550,10,0,0.0,6.0,8,83,314,397,0.721818182
1673002,90,11,385,165,550,10,0,1.1,4.5,9,185,289,474,0.861818182
1673003,90,11,385,165,550,10,0,0.0,6.0,10,209,323,532,0.967272727
1675001,116,34,595,1122,1717,24,0,0.0,0.0,29,1035,537,1572,0.915550379
1675002,116,34,595,1122,1717,24,0,0.0,0.0,29,295,1255,1550,0.902737333
1675003,116,34,595,1122,1717,24,0,0.0,0.0,30,637,928,1565,0.9114735
1675004,116,34,595,1122,1717,24,0,0.0,0.0,32,1201,439,1640,0.955154339
1675005,116,34,595,1122,1717,24,0,0.0,0.0,31,128,1469,1597,0.930110658
1675006,116,34,595,1122,1717,24,0,0.0,0.0,31,641,990,1631,0.949912638
1675007,116,34,595,1122,1717,24,0,0.0,0.0,29,135,1433,1568,0.913220734
1676001,112,13,260,416,676,10,1,0.0,2.0,15,540,120,660,0.976331361
1676002,112,13,260,416,676,10,1,0.0,2.0,14,572,86,658,0.973372781
1678001,96,10,155,235,390,10,0,0.1,0.9,10,-144,516,372,0.953846154
1678001,96,10,155,235,390,10,0,0.3,2.7,10,121,179,300,0.769230769
1678002,96,10,155,235,390,10,0,0.1,0.9,10,121,263,384,0.984615385
1678002,96,10,155,235,390,10,0,0.1,2.9,11,105,253,358,0.917948718
1678003,96,10,155,235,390,10,0,0.2,0.7,10,185,149,334,0.856410256
1678003,96,10,155,235,390,10,0,0.3,2.5,8,210,100,310,0.794871795
1678004,96,10,155,235,390,10,0,0.3,1.2,8,50,236,286,0.733333333
1678004,96,10,155,235,390,10,0,0.5,3.0,8,63,243,306,0.784615385
1679001,777,7,301,490,791,10,0,0.0,2.0,10,1009,-584,425,0.537294564
1679002,777,7,301,490,791,10,0,0.0,2.7,6,-3014,3345,331,0.418457649
1679003,777,7,301,490,791,10,0,0.0,2.0,9,-1226,1571,345,0.436156764
1679004,777,7,301,490,791,10,0,0.0,2.0,7,1422,-1007,415,0.524652339
1679005,777,7,301,490,791,10,0,0.0,2.0,9,-20,757,737,0.931731985
1679006,777,7,301,490,791,10,0,0.0,1.9,11,730,-185,545,0.689001264
1680001,500,18,4716,4716,9432,24,0,0.0,7.0416665,24,4365,2947,7312,0.775233249
1681001,78,13,312,156,468,10,0,1.2,6.8,9,45,339,384,0.820512821
1681001,78,13,312,156,468,10,0,1.2,7.8,11,61,357,418,0.893162393
1681002,78,13,312,156,468,10,0,0.8,6.3,11,38,362,400,0.854700855
1681002,78,13,312,156,468,10,0,0.8,7.3,12,121,321,442,0.944444444
1681003,78,13,312,156,468,10,0,0.8,7.2,9,76,326,402,0.858974359
1681003,78,13,312,156,468,10,0,0.8,8.2,9,55,311,366,0.782051282
1681004,78,13,312,156,468,10,0,1.4,5.4,11,-131,545,414,0.884615385
1681004,78,13,312,156,468,10,0,1.4,6.4,12,-93,515,422,0.901709402
1681005,75,6,174,84,258,5,0,2.6,4.4,3,65,97,162,0.627906977
1682001,110,13,234,390,624,10,0,0.0,0.0,13,227,365,592,0.948717949
1682002,110,13,234,390,624,10,0,0.0,0.0,10,210,340,550,0.881410256
1682003,110,13,234,390,624,10,0,0.1,0.0,9,-96,560,464,0.743589744
1682004,110,13,234,390,624,10,0,0.0,1.0,12,207,399,606,0.971153846
1682005,110,13,234,390,624,10,0,0.0,0.0,13,370,203,573,0.918269231
1683001,114,30,645,1050,1695,30,0,0.0,2.0,29,990,662,1652,0.974631268
1683002,114,30,645,1050,1695,30,0,0.0,2.0,24,757,700,1457,0.859587021
1683003,114,30,645,1050,1695,30,0,0.0,2.0,27,974,630,1604,0.946312684
1683004,114,30,645,1050,1695,30,0,0.0,2.0,28,-255,1887,1632,0.962831858
1683005,114,30,645,1050,1695,30,0,0.0,2.0,27,116,1461,1577,0.930383481
1683006,114,30,645,1050,1695,30,0,0.0,2.0,26,398,1157,1555,0.91740413
1683007,112,20,520,760,1280,20,0,0.0,2.0,9,298,398,696,0.54375
1685001,218,15,2130,1500,3630,14,0,0.0,0.0,17,1528,1608,3136,0.863911846
1687001,65,13,780,390,1170,10,0,0.5,4.5,7,95,835,930,0.794871795
1687001,65,13,780,390,1170,10,0,0.5,5.5,8,196,824,1020,0.871794872
1687002,65,13,780,390,1170,10,0,0.7,4.3,5,217,468,685,0.585470085
1687002,65,13,780,390,1170,10,0,0.7,5.3,8,394,596,990,0.846153846
1687003,65,13,780,390,1170,10,0,0.6,4.4,8,132,763,895,0.764957265
1687003,65,13,780,390,1170,10,0,0.6,5.4,6,237,458,695,0.594017094
1688001,135,4,42,80,122,10,0,0.0,4.8,3,53,45,98,0.803278689
1688002,135,4,42,80,122,10,0,0.0,5.0,5,28,80,108,0.885245902
1688003,135,4,42,80,122,10,0,0.0,5.0,4,139,-43,96,0.786885246
1688004,132,3,45,66,111,6,0,0.0,4.8333335,3,25,86,111,1.0
1689001,78,13,312,156,468,10,0,1.1,11.2,11,168,266,434,0.927350427
1689001,78,13,312,156,468,10,0,1.1,12.2,12,97,339,436,0.931623932
1689002,78,13,312,156,468,10,0,1.4,12.4,11,77,351,428,0.914529915
1689002,78,13,312,156,468,10,0,1.4,13.4,11,90,312,402,0.858974359
1689003,78,13,312,156,468,10,0,0.7,12.3,12,-9,437,428,0.914529915
1689003,78,13,312,156,468,10,0,0.7,13.3,10,139,239,378,0.807692308
1690001,100,13,314,314,628,26,0,0.0,1.9615384,12,248,328,576,0.917197452
1691001,100,39,1209,1209,2418,26,0,0.0,3.9230769,33,632,1555,2187,0.904466501
1692001,112,13,260,416,676,10,1,0.0,1.0,8,6,436,442,0.653846154
1692002,112,13,260,416,676,10,1,0.0,1.0,11,-548,1176,628,0.928994083
1692003,97,3,114,111,225,3,0,0.0,1.0,2,15,145,160,0.711111111
1693001,86,34,595,1122,1717,18,0,0.44444445,4.5555553,19,451,690,1141,0.664531159
1694001,116,34,595,1122,1717,24,0,0.16666667,0.8333333,29,406,1116,1522,0.886429819
1694001,116,34,595,1122,1717,24,0,0.16666667,1.8333334,34,489,1165,1654,0.963308096
1694002,116,34,595,1122,1717,24,0,0.083333336,0.9166667,30,577,996,1573,0.91613279
1694002,116,34,595,1122,1717,24,0,0.083333336,1.9166666,28,374,1185,1559,0.907979033
1694003,116,34,595,1122,1717,24,0,0.041666668,0.9583333,32,627,1052,1679,0.977868375
1694003,116,34,595,1122,1717,24,0,0.041666668,1.9583334,33,673,1025,1698,0.988934188
1694004,116,34,595,1122,1717,24,0,0.041666668,0.9583333,29,610,984,1594,0.928363425
1694004,116,34,595,1122,1717,24,0,0.041666668,1.9583334,31,575,1063,1638,0.953989517
1694005,116,34,595,1122,1717,24,0,0.083333336,0.9166667,30,776,883,1659,0.966220151
1694005,116,34,595,1122,1717,24,0,0.083333336,1.9166666,31,805,873,1678,0.977285964
1694006,116,34,595,1122,1717,24,0,0.083333336,0.9166667,28,487,1076,1563,0.910308678
1694006,116,34,595,1122,1717,24,0,0.083333336,1.9166666,31,529,1135,1664,0.969132207
1694007,116,34,595,1122,1717,24,0,0.083333336,0.9166667,31,587,1074,1661,0.967384974
1694007,116,34,595,1122,1717,24,0,0.083333336,1.9166666,34,680,1031,1711,0.996505533
1695001,78,13,312,156,468,10,0,0.2,6.5,10,152,242,394,0.841880342
1695001,78,13,312,156,468,10,0,0.2,7.5,9,180,202,382,0.816239316
1695002,78,13,312,156,468,10,0,0.4,8.0,7,84,240,324,0.692307692
1695002,78,13,312,156,468,10,0,0.4,9.0,7,33,303,336,0.717948718
1695003,78,13,312,156,468,10,0,2.0,6.7,10,191,225,416,0.888888889
1695003,78,13,312,156,468,10,0,2.0,7.7,7,-86,382,296,0.632478632
1695004,78,13,312,156,468,10,0,0.6,6.3,6,115,175,290,0.61965812
1695004,78,13,312,156,468,10,0,0.6,7.3,4,72,156,228,0.487179487
1695005,78,13,312,156,468,10,0,0.7,7.1,9,-95,445,350,0.747863248
1695005,78,13,312,156,468,10,0,0.7,8.1,10,-61,463,402,0.858974359
1699001,662,10,2380,1245,3625,34,0,0.0,10.764706,14,1470,1105,2575,0.710344828
1701001,489,16,4304,4260,8564,17,0,0.0,1.6470588,11,5668,1592,7260,0.847734703
1702001,660,9,2237,1215,3452,33,0,0.0,12.0,12,968,1758,2726,0.789687138
1705001,97,8,235,201,436,17,0,0.0,3.0,7,151,175,326,0.747706422
1707001,113,27,648,999,1647,18,0,0.0,1.0,26,515,1090,1605,0.974499089
1709001,102,18,522,558,1080,12,0,0.0,3.0,11,326,454,780,0.722222222
1709001,102,18,522,558,1080,12,0,0.0,4.0,14,188,714,902,0.835185185
1709001,102,18,522,558,1080,12,0,0.0,5.0,14,482,428,910,0.842592593
1709002,102,3,102,108,210,2,0,0.0,3.0,2,149,21,170,0.80952381
1710001,112,13,260,416,676,10,1,0.2,0.8,10,181,411,592,0.875739645
1710001,112,13,260,416,676,10,1,0.2,1.8,12,330,307,637,0.942307692
1710002,112,13,260,416,676,10,1,0.0,1.0,11,180,463,643,0.951183432
1710002,112,13,260,416,676,10,1,0.0,2.0,11,192,445,637,0.942307692
1710003,112,13,260,416,676,10,1,0.4,0.6,13,454,205,659,0.974852071
1710003,112,13,260,416,676,10,1,0.4,1.6,14,463,199,662,0.979289941
1711001,112,13,260,416,676,10,1,0.0,0.0,12,-56,656,600,0.887573964
1711002,112,13,260,416,676,10,1,0.0,0.0,12,-650,1253,603,0.892011834
1711003,110,3,75,105,180,2,0,0.0,0.0,3,171,9,180,1.0
1714001,105,12,276,330,606,25,0,0.0,3.64,8,302,15,317,0.52310231
1714002,100,1,50,50,100,3,0,0.0,4.0,1,30,70,100,1.0
1715001,115,13,624,455,1079,10,0,0.2,9.8,11,561,323,884,0.819277108
1715002,115,13,624,455,1079,10,0,0.2,9.8,13,385,679,1064,0.986098239
1715003,115,13,624,455,1079,10,0,0.1,9.9,13,664,410,1074,0.99536608
1718001,100,1,50,50,100,2,0,0.0,0.0,1,24,76,100,1.0
1718001,100,1,50,50,100,2,0,0.0,1.0,1,128,-28,100,1.0
1718003,100,1,50,50,100,2,0,0.0,0.0,1,50,50,100,1.0
1718004,100,1,50,50,100,2,0,0.0,0.0,1,54,46,100,1.0
1720001,107,9,207,315,522,10,0,0.8,1.3,13,43,363,406,0.777777778
1720002,107,9,207,315,522,10,0,0.6,1.5,8,-21,497,476,0.911877395
1720003,107,9,207,315,522,10,0,0.9,1.1,11,314,81,395,0.756704981
1720004,107,9,207,315,522,10,0,0.9,1.2,12,127,325,452,0.865900383
1720005,107,9,207,315,522,10,0,0.7,1.3,13,320,52,372,0.712643678
1720006,107,9,207,315,522,10,0,0.9,1.1,13,-79,423,344,0.659003831
1720007,107,9,207,315,522,10,0,0.7,1.3,12,251,67,318,0.609195402
1720008,105,6,165,222,387,6,0,0.33333334,1.6666666,5,154,141,295,0.762273902
1721001,112,13,260,416,676,10,1,0.0,0.0,13,179,468,647,0.957100592
1721001,112,13,260,416,676,10,1,0.0,1.0,13,107,541,648,0.958579882
1722001,112,13,260,416,676,10,1,0.3,0.7,9,262,250,512,0.75739645
1722002,112,13,260,416,676,10,1,0.4,0.6,8,-193,602,409,0.605029586
1722003,112,13,260,416,676,10,1,0.5,0.5,15,-151,811,660,0.976331361
1722004,112,13,260,416,676,10,1,0.2,0.8,15,106,554,660,0.976331361
1722006,112,13,260,416,676,10,1,0.3,0.7,10,253,311,564,0.834319527
1723001,112,13,260,416,676,10,1,1.5,5.7,14,315,343,658,0.973372781
1723002,112,13,260,416,676,10,1,1.0,7.6,13,66,594,660,0.976331361
1723003,112,13,260,416,676,10,1,1.2,6.4,14,355,306,661,0.977810651
1724001,112,13,260,416,676,10,1,0.0,2.8,14,236,436,672,0.99408284
1724002,112,13,260,416,676,10,1,0.0,3.0,13,256,417,673,0.99556213
1724003,112,13,260,416,676,10,1,0.0,3.0,13,193,472,665,0.983727811
1724004,101,6,195,201,396,5,0,0.0,3.0,6,164,232,396,1.0
1726001,112,13,260,416,676,10,1,0.0,3.0,10,36,594,630,0.931952663
1726001,112,13,260,416,676,10,1,0.0,4.0,12,206,402,608,0.899408284
1726001,112,13,260,416,676,10,1,0.0,5.0,13,309,347,656,0.970414201
1726001,112,13,260,416,676,10,1,0.0,6.0,14,284,379,663,0.980769231
1726002,112,13,260,416,676,10,1,0.3,2.7,13,100,559,659,0.974852071
1726002,112,13,260,416,676,10,1,0.3,3.7,13,146,524,670,0.99112426
1726002,112,13,260,416,676,10,1,0.3,4.7,14,196,467,663,0.980769231
1726002,112,13,260,416,676,10,1,0.3,5.7,14,301,368,669,0.98964497
1727001,78,13,312,156,468,10,0,4.4,5.6,8,91,301,392,0.837606838
1727001,78,13,312,156,468,10,0,4.4,6.6,6,157,167,324,0.692307692
1727002,78,13,312,156,468,10,0,5.3,6.1,7,63,291,354,0.756410256
1727002,78,13,312,156,468,10,0,5.3,7.1,5,71,219,290,0.61965812
1729001,400,14,1435,1435,2870,8,0,0.0,1.0,14,1388,1182,2570,0.895470383
1729002,400,14,1435,1435,2870,8,0,0.0,1.0,8,1812,338,2150,0.74912892
1729003,400,14,1435,1435,2870,8,0,0.0,1.0,12,1018,1232,2250,0.783972125
1729004,400,14,1435,1435,2870,8,0,0.0,1.0,16,1153,1467,2620,0.912891986
1729005,355,9,1185,720,1905,5,0,0.0,1.0,5,966,569,1535,0.805774278
1730001,96,24,300,552,852,10,0,0.0,0.0,17,447,277,724,0.849765258
1730001,96,24,300,552,852,10,0,0.0,1.0,19,241,519,760,0.892018779
1730001,96,24,300,552,852,10,0,0.0,2.0,21,302,504,806,0.94600939
1730002,96,24,300,552,852,10,0,0.0,0.0,19,228,523,751,0.881455399
1730002,96,24,300,552,852,10,0,0.0,1.0,20,114,674,788,0.924882629
1730002,96,24,300,552,852,10,0,0.0,2.0,18,584,156,740,0.868544601
1730003,96,24,300,552,852,10,0,0.0,0.0,16,216,508,724,0.849765258
1730003,96,24,300,552,852,10,0,0.0,1.0,20,140,605,745,0.874413146
1730003,96,24,300,552,852,10,0,0.0,2.0,24,411,439,850,0.997652582
1731001,119,50,1194,1225,2419,40,0,0.0,1.975,53,1410,962,2372,0.980570484
1731002,119,50,1194,1225,2419,40,0,0.0,1.975,55,957,1404,2361,0.97602315
1731003,119,50,1194,1225,2419,40,0,0.0,1.975,55,1097,1262,2359,0.975196362
1731004,119,50,1194,1225,2419,40,0,0.0,2.0,51,686,1577,2263,0.935510542
1731005,119,50,1194,1225,2419,40,0,0.0,1.975,55,1175,1125,2300,0.950806118
1731006,119,50,1194,1225,2419,40,0,0.0,2.025,47,948,1162,2179,0.900785449
1731007,119,50,1194,1225,2419,40,0,0.0,2.0,52,1446,790,2236,0.924348905
1731008,119,50,1194,1225,2419,40,0,0.0,2.0,51,949,1348,2297,0.949565936
1731009,114,27,651,648,1299,21,0,0.0,1.6190476,22,408,659,1067,0.821401078
1732001,112,13,260,416,676,10,1,0.4,3.9,12,-469,1009,540,0.798816568
1732002,112,13,260,416,676,10,1,0.0,4.5,12,227,390,617,0.912721893
1732003,112,13,260,416,676,10,1,0.0,3.8,11,381,233,614,0.908284024
1732004,112,13,260,416,676,10,1,0.0,4.7,13,235,413,648,0.958579882
1732005,112,13,260,416,676,10,1,0.2,3.8,12,356,265,621,0.918639053
1732006,112,13,260,416,676,10,1,0.1,4.5,6,320,55,375,0.554733728
1732007,112,11,223,357,580,8,0,0.0,4.25,11,282,280,562,0.968965517
1732008,112,13,260,416,676,10,1,0.0,3.7,8,134,352,486,0.718934911
1732009,112,13,260,416,676,10,1,0.0,3.9,11,419,137,556,0.822485207
1732010,106,15,345,420,765,10,0,0.0,3.8,7,424,51,475,0.620915033
1732011,112,13,260,416,676,10,1,0.1,4.3,10,335,179,514,0.76035503
1732012,112,13,260,416,676,10,1,0.0,3.7,9,90,345,435,0.643491124
1732013,112,13,260,416,676,10,1,0.0,4.5,13,132,489,621,0.918639053
1732015,112,13,260,416,676,10,1,0.0,3.8,12,81,585,666,0.985207101
1732016,112,13,260,416,676,10,1,0.1,3.9,13,537,123,660,0.976331361
1732017,112,13,260,416,676,10,1,0.0,3.8,9,527,13,540,0.798816568
1734003,111,6,135,201,336,4,0,0.0,0.0,1,-153,245,92,0.273809524
1734003,111,6,135,201,336,4,0,0.0,1.0,2,42,120,162,0.482142857
1735001,99,89,4407,4317,8724,179,0,0.0,0.0,64,3859,2524,6383,0.731659789
1735001,99,89,4407,4317,8724,179,0,0.0,1.0,56,-1124,6702,5578,0.639385603
1735001,99,89,4407,4317,8724,179,0,0.0,2.0,49,-297,5182,4885,0.559949564
1736001,110,21,420,630,1050,15,0,0.0,0.2,17,144,793,937,0.892380952
1736001,110,21,420,630,1050,15,0,0.0,1.2,17,718,142,860,0.819047619
1736001,110,21,420,630,1050,15,0,0.0,2.2,18,524,409,933,0.888571429
1736001,110,21,420,630,1050,15,0,0.0,3.2,15,212,646,858,0.817142857
1737001,110,13,234,390,624,10,0,0.2,0.8,11,305,193,498,0.798076923
1737002,110,13,234,390,624,10,0,0.2,0.8,14,180,424,604,0.967948718
1737003,110,13,234,390,624,10,0,0.2,0.9,12,118,458,576,0.923076923
1737004,110,13,234,390,624,10,0,0.1,0.9,13,221,391,612,0.980769231
1737005,110,13,234,390,624,10,0,0.1,0.9,11,526,-5,521,0.834935897
1743001,489,18,4644,4556,9200,19,0,0.0,5.0526314,18,4510,2490,7000,0.760869565
1744001,550,15,3750,3750,7500,20,0,0.1,0.9,15,2428,772,3200,0.426666667
1744002,550,15,3750,3750,7500,20,0,0.1,0.9,19,-1872,4372,2500,0.333333333
1744003,550,15,3750,3750,7500,20,0,0.1,0.85,19,1977,2123,4100,0.546666667
1744004,550,15,3750,3750,7500,20,0,0.05,0.95,21,3653,947,4600,0.613333333
1744005,550,15,3750,3750,7500,20,0,0.1,0.85,21,-4067,5267,1200,0.16
1744006,550,15,3750,3750,7500,20,0,0.0,0.9,17,4591,1209,5800,0.773333333
1744007,550,15,3750,3750,7500,20,0,0.05,0.95,16,2238,2062,4300,0.573333333
1744008,550,15,3750,3750,7500,20,0,0.05,0.95,17,2214,486,2700,0.36
1744009,550,15,3750,3750,7500,20,0,0.1,0.85,18,2177,3423,5600,0.746666667
1744010,550,15,3750,3750,7500,20,0,0.25,0.75,20,2389,1411,3800,0.506666667
1745001,110,13,234,390,624,10,0,0.0,1.0,12,190,395,585,0.9375
1745002,110,13,234,390,624,10,0,0.0,1.0,9,111,390,501,0.802884615
1745003,110,13,234,390,624,10,0,0.2,0.8,12,250,315,565,0.905448718
1745004,110,13,234,390,624,10,0,0.3,1.8,10,168,298,466,0.746794872
1745005,110,13,234,390,624,10,0,0.0,1.0,11,442,76,518,0.830128205
1746001,120,9,180,180,360,16,0,0.0,1.0,13,23,202,225,0.625
1746002,120,9,180,180,360,16,0,0.0,0.9375,11,407,-142,265,0.736111111
1746003,110,5,180,100,280,9,0,0.0,1.0,4,-303,473,170,0.607142857
1747001,107,15,330,435,765,14,0,0.42857143,2.5,17,152,536,688,0.899346405
1747002,107,15,330,435,765,14,0,0.42857143,2.5,16,73,629,702,0.917647059
1748001,81,10,100,166,266,14,0,0.0,1.0,12,34,162,196,0.736842105
1749001,112,13,260,416,676,10,1,0.0,0.0,7,9,459,468,0.692307692
1749001,112,13,260,416,676,10,1,0.0,1.0,11,140,471,611,0.903846154
1749001,112,13,260,416,676,10,1,0.0,2.0,13,232,428,660,0.976331361
1749002,112,13,260,416,676,10,1,0.0,0.0,10,272,305,577,0.853550296
1749002,112,13,260,416,676,10,1,0.0,1.0,14,222,432,654,0.967455621
1749002,112,13,260,416,676,10,1,0.0,2.0,14,387,280,667,0.986686391
1749003,112,13,260,416,676,10,1,0.0,0.0,7,52,320,372,0.550295858
1749003,112,13,260,416,676,10,1,0.0,1.0,12,350,214,564,0.834319527
1749003,112,13,260,416,676,10,1,0.0,2.0,10,249,292,541,0.800295858
1749004,112,13,260,416,676,10,1,0.0,0.0,9,253,216,469,0.693786982
1749004,112,13,260,416,676,10,1,0.0,1.0,11,240,282,522,0.772189349
1749004,112,13,260,416,676,10,1,0.0,2.0,10,36,497,533,0.788461538
1749005,112,13,260,416,676,10,1,0.0,0.0,10,704,-145,559,0.826923077
1749005,112,13,260,416,676,10,1,0.0,1.0,13,280,378,658,0.973372781
1749005,112,13,260,416,676,10,1,0.0,2.0,12,443,211,654,0.967455621
1749006,112,13,260,416,676,10,1,0.0,0.0,9,483,62,545,0.806213018
1749006,112,13,260,416,676,10,1,0.0,1.0,13,463,195,658,0.973372781
1749006,112,13,260,416,676,10,1,0.0,2.0,11,455,166,621,0.918639053
1749007,112,13,260,416,676,10,1,0.0,0.0,10,327,269,596,0.881656805
1749007,112,13,260,416,676,10,1,0.0,1.0,12,387,205,592,0.875739645
1749007,112,13,260,416,676,10,1,0.0,2.0,12,364,283,647,0.957100592
1749008,112,13,260,416,676,10,1,0.0,0.0,10,68,501,569,0.841715976
1749008,112,13,260,416,676,10,1,0.0,1.0,11,296,317,613,0.906804734
1749008,112,13,260,416,676,10,1,0.0,2.0,11,367,235,602,0.890532544
1749009,112,13,260,416,676,10,1,0.0,0.0,10,356,243,599,0.886094675
1749009,112,13,260,416,676,10,1,0.0,1.0,11,273,311,584,0.863905325
1749009,112,13,260,416,676,10,1,0.0,2.0,10,315,278,593,0.877218935
1749010,112,13,260,416,676,10,1,0.0,0.0,9,187,310,497,0.735207101
1749010,112,13,260,416,676,10,1,0.0,1.0,10,209,373,582,0.860946746
1749010,112,13,260,416,676,10,1,0.0,2.0,12,575,61,636,0.940828402
1749011,112,13,260,416,676,10,1,0.0,0.0,7,25,442,467,0.690828402
1749011,112,13,260,416,676,10,1,0.0,1.0,11,298,326,624,0.923076923
1749011,112,13,260,416,676,10,1,0.0,2.0,10,338,238,576,0.852071006
1749012,112,13,260,416,676,10,1,0.0,0.0,9,227,263,490,0.724852071
1749012,112,13,260,416,676,10,1,0.0,1.0,12,149,465,614,0.908284024
1749012,112,13,260,416,676,10,1,0.0,2.0,11,383,227,610,0.902366864
1749013,112,13,260,416,676,10,1,0.0,0.0,9,156,387,543,0.803254438
1749013,112,13,260,416,676,10,1,0.0,1.0,12,826,-192,634,0.937869822
1749013,112,13,260,416,676,10,1,0.0,2.0,8,309,180,489,0.723372781
1749014,112,13,260,416,676,10,1,0.0,0.0,9,182,280,462,0.683431953
1749014,112,13,260,416,676,10,1,0.0,1.0,11,272,370,642,0.949704142
1749014,112,13,260,416,676,10,1,0.0,2.0,9,374,180,554,0.819526627
1749015,112,13,260,416,676,10,1,0.0,0.0,11,537,63,600,0.887573964
1749015,112,13,260,416,676,10,1,0.0,1.0,12,204,408,612,0.905325444
1749015,112,13,260,416,676,10,1,0.0,2.0,14,228,434,662,0.979289941
1749016,112,13,260,416,676,10,1,0.0,0.2,12,218,423,641,0.948224852
1749016,112,13,260,416,676,10,1,0.0,1.2,10,-9,531,522,0.772189349
1749016,112,13,260,416,676,10,1,0.0,2.2,12,179,421,600,0.887573964
1749017,112,13,260,416,676,10,1,0.0,0.0,11,66,537,603,0.892011834
1749017,112,13,260,416,676,10,1,0.0,1.0,12,133,482,615,0.909763314
1749017,112,13,260,416,676,10,1,0.0,2.0,11,194,385,579,0.856508876
1749018,112,13,260,416,676,10,1,0.0,0.0,10,121,450,571,0.844674556
1749018,112,13,260,416,676,10,1,0.0,1.0,12,107,531,638,0.943786982
1749018,112,13,260,416,676,10,1,0.0,2.0,12,156,430,586,0.866863905
1749019,112,13,260,416,676,10,1,0.0,0.0,10,328,269,597,0.883136095
1749019,112,13,260,416,676,10,1,0.0,1.0,13,495,135,630,0.931952663
1749019,112,13,260,416,676,10,1,0.0,2.0,14,559,96,655,0.968934911
1749020,112,13,260,416,676,10,1,0.0,0.0,11,-287,852,565,0.835798817
1749020,112,13,260,416,676,10,1,0.0,1.0,13,115,537,652,0.964497041
1749020,112,13,260,416,676,10,1,0.0,2.0,13,151,480,631,0.933431953
1749021,112,13,260,416,676,10,1,0.0,0.0,10,164,363,527,0.779585799
1749021,112,13,260,416,676,10,1,0.0,1.0,9,364,165,529,0.782544379
1749021,112,13,260,416,676,10,1,0.0,2.0,10,146,372,518,0.766272189
1749022,112,13,260,416,676,10,1,0.0,0.0,11,239,347,586,0.866863905
1749022,112,13,260,416,676,10,1,0.0,1.0,13,313,354,667,0.986686391
1749022,112,13,260,416,676,10,1,0.0,2.0,12,217,424,641,0.948224852
1749023,112,13,260,416,676,10,1,0.0,0.0,7,392,18,410,0.606508876
1749023,112,13,260,416,676,10,1,0.0,1.0,8,340,218,558,0.825443787
1749023,112,13,260,416,676,10,1,0.0,2.0,11,263,316,579,0.856508876
1749024,112,13,260,416,676,10,1,0.0,0.0,9,322,230,552,0.816568047
1749024,112,13,260,416,676,10,1,0.0,1.0,11,467,81,548,0.810650888
1749024,112,13,260,416,676,10,1,0.0,2.0,10,175,331,506,0.74852071
1749025,107,9,225,303,528,7,0,0.0,0.0,4,31,300,331,0.626893939
1749025,107,9,225,303,528,7,0,0.0,1.0,7,44,329,373,0.706439394
1749025,112,11,223,357,580,8,0,0.0,1.75,5,165,182,347,0.598275862
1753001,112,13,260,416,676,10,1,0.0,0.0,14,496,165,661,0.977810651
1753002,112,13,260,416,676,10,1,0.0,0.0,15,384,276,660,0.976331361
1753003,112,13,260,416,676,10,1,0.0,0.0,14,459,202,661,0.977810651
1753004,112,13,260,416,676,10,1,0.0,0.0,10,516,90,606,0.896449704
1753005,112,13,260,416,676,10,1,0.0,0.0,11,325,326,651,0.963017751
1753006,112,13,260,416,676,10,1,0.0,0.0,10,198,379,577,0.853550296
1753007,112,13,260,416,676,10,1,0.0,0.0,12,235,362,597,0.883136095
1753008,112,13,260,416,676,10,1,0.0,0.0,14,465,180,645,0.954142012
1753009,112,13,260,416,676,10,1,0.0,0.0,14,175,492,667,0.986686391
1753010,112,13,260,416,676,10,1,0.0,0.0,10,213,346,559,0.826923077
1753011,112,13,260,416,676,10,1,0.0,0.0,14,448,210,658,0.973372781
1753012,112,13,260,416,676,10,1,0.0,0.0,11,19,566,585,0.865384615
1753013,112,13,260,416,676,10,1,0.0,0.0,13,40,610,650,0.961538462
1753014,112,13,260,416,676,10,1,0.0,0.0,11,-878,1511,633,0.936390533
1754002,90,11,275,275,550,8,0,0.0,0.0,13,276,234,510,0.927272727
1754002,90,11,275,275,550,8,0,0.0,1.0,12,295,230,525,0.954545455
1756001,112,13,260,416,676,10,1,0.4,4.6,7,43,381,424,0.627218935
1756001,112,13,260,416,676,10,1,0.4,5.6,12,232,375,607,0.897928994
1756002,112,13,260,416,676,10,1,0.8,3.9,10,137,372,509,0.75295858
1756002,112,13,260,416,676,10,1,0.8,4.9,11,192,448,640,0.946745562
1756003,112,13,260,416,676,10,1,0.4,4.6,9,282,275,557,0.823964497
1756003,112,13,260,416,676,10,1,0.4,5.6,8,128,335,463,0.684911243
1756004,112,13,260,416,676,10,1,0.2,4.6,9,297,269,566,0.837278107
1756004,112,13,260,416,676,10,1,0.2,5.6,10,245,264,509,0.75295858
1757001,108,12,300,390,690,8,0,0.0,10.875,10,-47,670,623,0.902898551
1757001,108,12,300,390,690,8,0,0.0,11.875,8,418,84,502,0.727536232
1759001,96,10,155,235,390,10,0,0.0,2.0,8,96,241,337,0.864102564
1759001,96,10,155,235,390,10,0,0.0,3.0,10,117,254,371,0.951282051
1759002,96,10,155,235,390,10,0,0.2,1.8,9,-41,391,350,0.897435897
1759002,96,10,155,235,390,10,0,0.2,2.8,10,74,214,288,0.738461538
1759003,96,10,155,235,390,10,0,0.0,2.0,7,128,170,298,0.764102564
1759003,96,10,155,235,390,10,0,0.0,3.0,9,184,159,343,0.879487179
1759004,96,10,155,235,390,10,0,0.2,1.8,11,147,210,357,0.915384615
1759004,96,10,155,235,390,10,0,0.2,2.8,11,84,276,360,0.923076923
1760001,112,21,546,798,1344,14,0,0.0,1.0,21,903,441,1344,1.0
1761001,112,13,260,416,676,10,1,0.4,6.2,10,288,275,563,0.832840237
1761002,112,13,260,416,676,10,1,0.9,6.8,9,139,407,546,0.807692308
1761003,112,13,260,416,676,10,1,1.4,5.7,13,302,358,660,0.976331361
1762001,77,24,624,876,1500,16,0,0.0625,0.875,21,139,1264,1403,0.935333333
1762002,77,24,624,876,1500,16,0,0.0,1.0,19,575,774,1349,0.899333333
1762003,77,24,624,876,1500,16,0,0.1875,0.75,20,291,1086,1377,0.918
1762004,77,24,624,876,1500,16,0,0.0625,0.9375,21,85,1362,1447,0.964666667
1762005,77,24,624,876,1500,16,0,0.0625,0.9375,17,186,978,1164,0.776
1762006,77,24,624,876,1500,16,0,0.125,0.875,20,180,1216,1396,0.930666667
1762006,77,24,624,876,1500,16,0,0.125,1.875,1,11,83,94,0.062666667
1762007,77,24,624,876,1500,16,0,0.0625,0.9375,20,205,1152,1357,0.904666667
1762008,77,24,624,876,1500,16,0,0.0625,0.875,20,173,1152,1325,0.883333333
1762009,77,24,624,876,1500,16,0,0.0,1.0,19,508,783,1291,0.860666667
1762010,77,24,624,876,1500,16,0,0.0,1.0,21,532,792,1324,0.882666667
1763001,110,13,234,390,624,10,0,0.0,2.0,9,204,252,456,0.730769231
1763002,110,13,234,390,624,10,0,0.0,1.9,5,267,17,284,0.455128205
1763003,110,13,234,390,624,10,0,0.0,2.0,11,-115,690,575,0.921474359
1763004,110,13,234,390,624,10,0,0.0,1.7,7,220,202,422,0.676282051
1763005,110,13,234,390,624,10,0,0.0,2.0,8,-217,691,474,0.759615385
1763006,110,13,234,390,624,10,0,0.0,1.9,7,192,278,470,0.753205128
1763007,110,11,201,335,536,8,0,0.0,1.625,6,-137,497,360,0.671641791
1764001,112,13,260,416,676,10,1,0.0,1.0,13,433,209,642,0.949704142
1764002,112,13,260,416,676,10,1,0.0,1.0,11,426,196,622,0.920118343
1764003,112,13,260,416,676,10,1,0.1,1.5,15,339,321,660,0.976331361
1764004,112,13,260,416,676,10,1,0.0,1.0,15,51,609,660,0.976331361
1766001,96,10,155,235,390,10,0,0.1,1.9,11,97,276,373,0.956410256
1766001,96,10,155,235,390,10,0,0.1,2.9,8,42,240,282,0.723076923
1766002,96,10,155,235,390,10,0,0.1,1.9,11,99,254,353,0.905128205
1766002,96,10,155,235,390,10,0,0.1,2.9,9,82,269,351,0.9
1766003,96,10,155,235,390,10,0,0.2,1.8,10,34,325,359,0.920512821
1766003,96,10,155,235,390,10,0,0.2,2.8,10,42,218,260,0.666666667
1766004,96,10,155,235,390,10,0,0.1,1.9,11,-370,692,322,0.825641026
1766004,96,10,155,235,390,10,0,0.1,2.9,13,-288,561,273,0.7
1766005,96,10,155,235,390,10,0,0.1,2.0,9,-233,524,291,0.746153846
1766005,96,10,155,235,390,10,0,0.1,3.0,11,157,175,332,0.851282051
1769001,110,13,234,390,624,10,0,0.0,1.0,12,251,350,601,0.963141026
1769002,106,12,246,342,588,9,0,0.11111111,1.4444444,11,295,188,483,0.821428571
1770001,107,15,330,435,765,11,0,0.0,1.9090909,11,-207,800,593,0.775163399
1770002,107,15,330,435,765,11,0,0.0,2.0,12,-97,739,642,0.839215686
1771001,96,10,155,235,390,10,0,0.8,5.2,7,55,251,306,0.784615385
1771001,96,10,155,235,390,10,0,0.8,6.2,7,101,235,336,0.861538462
1771002,96,10,155,235,390,10,0,0.7,5.3,9,142,215,357,0.915384615
1771002,96,10,155,235,390,10,0,0.7,6.3,9,121,251,372,0.953846154
1771003,96,10,155,235,390,10,0,0.7,4.8,7,-2,261,259,0.664102564
1771003,96,10,155,235,390,10,0,0.7,5.8,5,61,186,247,0.633333333
1771004,96,10,155,235,390,10,0,0.2,5.8,12,69,272,341,0.874358974
1771004,96,10,155,235,390,10,0,0.2,6.8,12,78,257,335,0.858974359
1773001,78,13,312,156,468,10,0,0.7,9.6,12,60,372,432,0.923076923
1773001,78,13,312,156,468,10,0,0.7,10.6,14,87,371,458,0.978632479
1773002,78,13,312,156,468,10,0,1.7,6.9,10,300,60,360,0.769230769
1773002,78,13,312,156,468,10,0,1.7,7.9,10,374,-26,348,0.743589744
1774001,100,16,240,240,480,20,0,0.0,0.0,20,130,134,264,0.55
1774001,100,16,240,240,480,20,0,0.0,1.0,18,230,196,426,0.8875
1774001,100,16,240,240,480,20,0,0.0,2.0,19,238,140,378,0.7875
1774001,100,16,240,240,480,20,0,0.0,3.0,16,284,142,426,0.8875
1774002,100,16,240,240,480,20,0,0.0,0.0,21,50,236,286,0.595833333
1774002,100,16,240,240,480,20,0,0.0,1.0,20,-68,426,358,0.745833333
1774002,100,16,240,240,480,20,0,0.0,2.0,20,183,147,330,0.6875
1774002,100,16,240,240,480,20,0,0.0,3.0,18,146,204,350,0.729166667
1774003,100,16,240,240,480,20,0,0.0,0.0,24,38,228,266,0.554166667
1774003,100,16,240,240,480,20,0,0.0,1.0,23,124,204,328,0.683333333
1774003,100,16,240,240,480,20,0,0.0,2.0,19,272,112,384,0.8
1774003,100,16,240,240,480,20,0,0.0,3.0,16,279,183,462,0.9625
1774004,100,16,240,240,480,20,0,0.0,0.0,22,-32,282,250,0.520833333
1774004,100,16,240,240,480,20,0,0.0,1.0,15,40,318,358,0.745833333
1774004,100,16,240,240,480,20,0,0.0,2.0,17,11,357,368,0.766666667
1774004,100,16,240,240,480,20,0,0.0,3.0,17,93,221,314,0.654166667
1774005,100,16,240,240,480,20,0,0.0,0.0,19,140,110,250,0.520833333
1774005,100,16,240,240,480,20,0,0.0,1.0,19,339,3,342,0.7125
1774005,100,16,240,240,480,20,0,0.0,2.0,20,111,175,286,0.595833333
1774005,100,16,240,240,480,20,0,0.0,3.0,18,14,334,348,0.725
1774006,100,16,240,240,480,20,0,0.0,0.0,20,172,174,346,0.720833333
1774006,100,16,240,240,480,20,0,0.0,1.0,24,268,28,296,0.616666667
1774006,100,16,240,240,480,20,0,0.0,2.0,16,241,205,446,0.929166667
1774006,100,16,240,240,480,20,0,0.0,3.0,16,142,262,404,0.841666667
1774007,100,16,240,240,480,20,0,0.1,0.0,24,125,39,164,0.341666667
1774007,100,16,240,240,480,20,0,0.1,1.0,20,509,-241,268,0.558333333
1774007,100,16,240,240,480,20,0,0.1,2.0,21,218,82,300,0.625
1774007,100,16,240,240,480,20,0,0.1,3.0,18,185,233,418,0.870833333
1774008,100,16,240,240,480,20,0,0.0,0.2,22,104,88,192,0.4
1774008,100,16,240,240,480,20,0,0.0,1.2,21,156,224,380,0.791666667
1774008,100,16,240,240,480,20,0,0.0,2.2,21,152,184,336,0.7
1774008,100,16,240,240,480,20,0,0.0,3.2,16,124,304,428,0.891666667
1774009,100,16,240,240,480,20,0,0.0,0.0,25,-161,399,238,0.495833333
1774009,100,16,240,240,480,20,0,0.0,1.0,21,7,253,260,0.541666667
1774009,100,16,240,240,480,20,0,0.0,2.0,20,102,226,328,0.683333333
1774009,100,16,240,240,480,20,0,0.0,3.0,16,138,212,350,0.729166667
1774010,100,16,240,240,480,20,0,0.0,0.0,19,171,85,256,0.533333333
1774010,100,16,240,240,480,20,0,0.0,1.0,21,-321,561,240,0.5
1774010,100,16,240,240,480,20,0,0.0,2.0,21,-225,397,172,0.358333333
1774010,100,16,240,240,480,20,0,0.0,3.0,17,32,294,326,0.679166667
1774011,100,16,240,240,480,20,0,0.0,0.0,18,182,-40,142,0.295833333
1774011,100,16,240,240,480,20,0,0.0,1.0,20,302,-120,182,0.379166667
1774011,100,16,240,240,480,20,0,0.0,2.0,16,225,-39,186,0.3875
1774011,100,16,240,240,480,20,0,0.0,3.0,12,355,-73,282,0.5875
1775001,112,13,260,416,676,10,1,0.0,11.7,8,141,387,528,0.781065089
1775002,112,13,260,416,676,10,1,0.0,10.6,10,384,203,587,0.868343195
1775003,112,11,223,357,580,8,0,0.0,12.25,8,118,388,506,0.872413793
1776001,100,25,650,650,1300,10,0,0.0,1.3,19,306,872,1178,0.906153846
1776001,100,25,650,650,1300,10,0,0.0,2.3,21,234,954,1188,0.913846154
1776001,100,25,650,650,1300,10,0,0.0,3.3,23,351,905,1256,0.966153846
1776001,100,25,650,650,1300,10,0,0.0,4.3,21,434,794,1228,0.944615385
1776002,100,25,650,650,1300,10,0,0.0,1.0,14,194,794,988,0.76
1776002,100,25,650,650,1300,10,0,0.0,2.0,17,179,821,1000,0.769230769
1776002,100,25,650,650,1300,10,0,0.0,3.0,22,257,997,1254,0.964615385
1776002,100,25,650,650,1300,10,0,0.0,4.0,20,221,971,1192,0.916923077
1776003,100,25,650,650,1300,10,0,0.0,1.0,13,-439,1335,896,0.689230769
1776003,100,25,650,650,1300,10,0,0.0,2.0,19,388,734,1122,0.863076923
1776003,100,25,650,650,1300,10,0,0.0,3.0,18,18,1066,1084,0.833846154
1776003,100,25,650,650,1300,10,0,0.0,4.0,19,184,918,1102,0.847692308
1776004,100,25,650,650,1300,10,0,0.0,1.0,19,413,637,1050,0.807692308
1776004,100,25,650,650,1300,10,0,0.0,2.0,18,181,829,1010,0.776923077
1776004,100,25,650,650,1300,10,0,0.0,3.0,14,327,553,880,0.676923077
1776004,100,25,650,650,1300,10,0,0.0,4.0,14,439,473,912,0.701538462
1776005,100,25,650,650,1300,10,0,0.0,0.8,16,490,518,1008,0.775384615
1776005,100,25,650,650,1300,10,0,0.0,1.8,18,643,417,1060,0.815384615
1776005,100,25,650,650,1300,10,0,0.0,2.8,15,228,684,912,0.701538462
1776005,100,25,650,650,1300,10,0,0.0,3.8,16,92,866,958,0.736923077
1776006,100,25,650,650,1300,10,0,0.0,1.2,18,48,1094,1142,0.878461538
1776006,100,25,650,650,1300,10,0,0.0,2.2,20,580,596,1176,0.904615385
1776006,100,25,650,650,1300,10,0,0.0,3.2,20,433,711,1144,0.88
1776006,100,25,650,650,1300,10,0,0.0,4.2,19,296,882,1178,0.906153846
1776007,100,25,650,650,1300,10,0,0.0,1.0,17,575,501,1076,0.827692308
1776007,100,25,650,650,1300,10,0,0.0,2.0,17,515,461,976,0.750769231
1776007,100,25,650,650,1300,10,0,0.0,3.0,18,370,712,1082,0.832307692
1776007,100,25,650,650,1300,10,0,0.0,4.0,17,535,495,1030,0.792307692
1776008,100,25,650,650,1300,10,0,0.0,1.0,16,-169,1183,1014,0.78
1776008,100,25,650,650,1300,10,0,0.0,2.0,16,266,736,1002,0.770769231
1776008,100,25,650,650,1300,10,0,0.0,3.0,20,193,959,1152,0.886153846
1776008,100,25,650,650,1300,10,0,0.0,4.0,19,260,778,1038,0.798461538
1776009,100,25,650,650,1300,10,0,0.0,1.6,16,438,520,958,0.736923077
1776009,100,25,650,650,1300,10,0,0.0,2.6,17,515,533,1048,0.806153846
1776009,100,25,650,650,1300,10,0,0.0,3.6,13,327,505,832,0.64
1776009,100,25,650,650,1300,10,0,0.0,4.6,15,418,474,892,0.686153846
1776010,100,25,650,650,1300,10,0,0.0,1.0,16,-11,1055,1044,0.803076923
1776010,100,25,650,650,1300,10,0,0.0,2.0,21,200,1034,1234,0.949230769
1776010,100,25,650,650,1300,10,0,0.0,3.0,21,313,911,1224,0.941538462
1776010,100,25,650,650,1300,10,0,0.0,4.0,19,320,852,1172,0.901538462
1776011,100,25,650,650,1300,10,0,0.0,1.3,11,191,565,756,0.581538462
1776011,100,25,650,650,1300,10,0,0.0,2.3,16,32,942,974,0.749230769
1776011,100,25,650,650,1300,10,0,0.0,3.3,16,259,775,1034,0.795384615
1776011,100,25,650,650,1300,10,0,0.0,4.3,17,259,805,1064,0.818461538
1777001,112,13,260,416,676,10,1,0.0,9.5,12,201,461,662,0.979289941
1781001,345,6,195,465,660,8,0,0.25,0.875,8,-25,464,439,0.665151515
1781002,345,6,195,465,660,8,0,0.25,0.75,7,612,-139,473,0.716666667
1781003,345,6,195,465,660,8,0,0.0,1.0,7,57,155,212,0.321212121
1782001,135,6,45,255,300,10,0,2.7,4.2,4,-157,374,217,0.723333333
1782001,135,6,45,255,300,10,0,2.7,5.2,6,4,27,31,0.103333333
1782002,135,6,45,255,300,10,0,2.0,5.4,6,119,104,223,0.743333333
1782002,135,6,45,255,300,10,0,2.0,6.4,7,99,-62,37,0.123333333
1783001,100,30,915,915,1830,20,0,0.0,0.9,27,1063,642,1705,0.931693989
1784001,489,16,4304,4260,8564,17,0,0.0,2.6470587,14,1393,6007,7400,0.864082205
1786001,112,13,260,416,676,10,1,1.1,0.3,8,251,250,501,0.74112426
1786002,112,13,260,416,676,10,1,0.0,0.0,2,140,33,173,0.25591716
1787001,110,13,234,390,624,10,0,0.2,2.8,14,-70,672,602,0.96474359
1787002,110,13,234,390,624,10,0,0.4,2.6,14,153,454,607,0.97275641
1788001,112,13,260,416,676,10,1,0.0,1.2,11,7,542,549,0.812130178
1788002,112,13,260,416,676,10,1,0.0,1.0,14,80,573,653,0.965976331
1789001,118,9,144,216,360,8,0,0.375,0.625,8,148,186,334,0.927777778
1789002,118,9,144,216,360,8,0,0.125,0.875,9,185,161,346,0.961111111
1789003,118,9,144,216,360,8,0,0.125,0.875,9,168,192,360,1.0
1789004,118,9,144,216,360,8,0,0.375,0.625,8,58,282,340,0.944444444
1790001,100,21,672,672,1344,14,0,4.928571,6.428571,7,235,328,563,0.41889881
1793001,100,25,650,650,1300,10,0,2.0,5.6,19,454,740,1194,0.918461538
1793002,100,25,650,650,1300,10,0,2.0,5.9,22,615,621,1236,0.950769231
1795001,97,3,114,111,225,3,0,0.0,2.0,2,132,48,180,0.8
1796001,102,49,1329,1284,2613,35,0,0.0,1.0,49,1514,1000,2514,0.962112514
1797001,112,13,260,416,676,10,1,0.0,2.9,9,658,-68,590,0.872781065
1797002,112,13,260,416,676,10,1,0.0,3.0,11,198,394,592,0.875739645
1797003,112,13,260,416,676,10,1,0.0,3.0,8,115,386,501,0.74112426
1797004,112,13,260,416,676,10,1,0.0,3.0,9,183,309,492,0.727810651
1797005,112,13,260,416,676,10,1,0.2,2.8,10,154,383,537,0.794378698
1798001,220,11,1540,1100,2640,10,0,1.1,6.3,2,244,496,740,0.28030303
1798002,220,11,1540,1100,2640,10,0,1.2,5.9,1,444,-40,404,0.153030303
1799001,675,11,1395,1395,2790,36,0,0.0,4.0,16,1177,251,1428,0.511827957
1803001,125,50,649,1209,1858,50,0,0.02,0.32,63,626,794,1420,0.764262648
1803001,125,50,649,1209,1858,50,0,0.02,1.32,56,996,454,1450,0.780409042
1803001,125,50,649,1209,1858,50,0,0.02,2.32,58,701,764,1465,0.788482239
1803002,125,50,649,1209,1858,50,0,0.06,0.2,52,1329,-21,1308,0.703982777
1803002,125,50,649,1209,1858,50,0,0.06,1.2,59,622,818,1440,0.775026911
1803002,125,50,649,1209,1858,50,0,0.06,2.2,48,870,638,1508,0.811625404
1804001,100,3,66,86,152,2,0,0.0,0.0,3,53,99,152,1.0
1805001,110,13,234,390,624,10,0,0.0,2.0,13,185,400,585,0.9375
1805002,110,13,234,390,624,10,0,0.1,2.0,13,74,513,587,0.940705128
1805003,110,13,234,390,624,10,0,0.0,2.0,12,132,478,610,0.977564103
1805004,110,13,234,390,624,10,0,0.0,2.0,13,284,334,618,0.990384615
1805005,110,13,234,390,624,10,0,0.0,2.0,11,233,354,587,0.940705128
1805006,105,9,207,285,492,7,0,0.0,2.0,5,113,154,267,0.542682927
1806001,75,16,600,600,1200,51,0,0.0,0.0,17,222,613,835,0.695833333
1806001,75,16,600,600,1200,52,0,0.0,0.9807692,19,-210,810,600,0.5
1806001,75,16,600,600,1200,52,0,0.0,1.9807693,17,420,410,830,0.691666667
1806001,75,16,600,600,1200,52,0,0.0,2.9807692,19,452,548,1000,0.833333333
1806001,75,16,600,600,1200,52,0,0.0,3.9807692,18,590,415,1005,0.8375
1806001,75,16,600,600,1200,52,0,0.0,4.980769,18,572,338,910,0.758333333
1806001,75,16,600,600,1200,52,0,0.0,5.980769,19,465,385,850,0.708333333
1808001,116,17,306,578,884,12,0,0.0,0.0,15,261,559,820,0.92760181
1808002,116,17,306,578,884,12,0,0.0,0.0,14,272,508,780,0.882352941
1808003,111,12,288,432,720,9,0,0.0,0.0,10,-8,608,600,0.833333333
1810001,112,13,260,416,676,10,1,1.2,3.7,12,42,600,642,0.949704142
1810002,112,13,260,416,676,10,1,1.0,4.9,14,147,522,669,0.98964497
1810003,107,9,225,303,528,7,0,2.0,3.2857144,9,242,271,513,0.971590909
1811001,78,13,312,156,468,10,0,0.9,10.3,14,191,265,456,0.974358974
1811001,78,13,312,156,468,10,0,0.9,11.3,12,323,137,460,0.982905983
1811002,78,13,312,156,468,10,0,0.5,9.9,12,148,298,446,0.952991453
1811002,78,13,312,156,468,10,0,0.5,10.9,12,183,261,444,0.948717949
1811003,78,13,312,156,468,10,0,0.8,9.5,13,327,103,430,0.918803419
1811003,78,13,312,156,468,10,0,0.8,10.5,12,305,143,448,0.957264957
1811004,78,13,312,156,468,10,0,1.9,9.2,12,123,309,432,0.923076923
1811004,78,13,312,156,468,10,0,1.9,10.2,14,156,290,446,0.952991453
1811005,78,13,312,156,468,10,0,1.8,8.7,13,87,379,466,0.995726496
1811005,78,13,312,156,468,10,0,1.8,9.7,14,204,250,454,0.97008547
1812001,109,20,440,610,1050,8,0,0.0,3.0,13,322,485,807,0.768571429
1812001,109,20,440,610,1050,8,0,0.0,4.0,13,284,526,810,0.771428571
1812002,109,20,440,610,1050,8,0,0.0,3.0,15,343,526,869,0.827619048
1812002,109,20,440,610,1050,8,0,0.0,4.0,19,830,200,1030,0.980952381
1815001,110,13,234,390,624,10,0,0.5,1.6,13,-112,716,604,0.967948718
1815002,110,13,234,390,624,10,0,0.1,0.9,12,293,282,575,0.921474359
1815003,110,13,234,390,624,10,0,0.2,0.7,14,-242,832,590,0.945512821
1816001,115,33,1089,1089,2178,14,0,0.0,2.142857,16,495,901,1396,0.640955005
1817001,105,52,1425,1446,2871,39,0,0.74358976,0.74358976,50,1423,1272,2695,0.938697318
1817001,105,52,1425,1446,2871,39,0,0.74358976,1.7435898,50,1316,1453,2769,0.964472309
1817001,105,52,1425,1446,2871,39,0,0.74358976,2.7435896,48,1295,1392,2687,0.935910832
1819001,112,13,260,416,676,10,1,0.0,0.0,9,141,340,481,0.711538462
1819002,112,13,260,416,676,10,1,0.0,0.0,9,465,119,584,0.863905325
1819003,112,13,260,416,676,10,1,0.0,0.0,11,100,521,621,0.918639053
1819004,112,13,260,416,676,10,1,0.0,0.0,7,242,269,511,0.75591716
1819005,112,13,260,416,676,10,1,0.0,0.0,9,216,247,463,0.684911243
1824001,109,18,396,558,954,13,0,0.0,2.0,10,238,401,639,0.669811321
1827001,110,13,234,390,624,10,0,0.1,2.4,13,193,419,612,0.980769231
1827003,108,3,69,99,168,2,0,0.0,2.0,2,74,78,152,0.904761905
1829001,120,6,105,195,300,12,0,0.0,4.0,5,-163,433,270,0.9
1829001,120,6,105,195,300,12,0,0.0,5.0,5,-72,346,274,0.913333333
1829001,120,6,105,195,300,12,0,0.0,6.0,5,-53,327,274,0.913333333
1829001,120,6,105,195,300,12,0,0.0,7.0,6,-168,468,300,1.0
1830001,108,156,3492,4923,8415,60,0,0.016666668,5.4166665,128,3504,3539,7043,0.836957813
1830002,108,156,3492,4923,8415,60,0,0.033333335,5.616667,148,3207,4381,7588,0.901723113
1830003,108,156,3492,4923,8415,60,0,0.016666668,5.5,142,3265,4035,7300,0.867498515
1830004,108,156,3492,4923,8415,60,0,0.06666667,5.8333335,149,3322,4143,7465,0.887106358
1830005,108,156,3492,4923,8415,60,0,0.06666667,5.4333334,137,3751,3376,7127,0.846939988
1833001,100,44,1122,1122,2244,22,0,0.0,1.3636364,21,508,995,1503,0.669786096
1833001,98,44,1210,1106,2316,23,0,0.0,2.5217392,37,841,1314,2155,0.930483592
1833001,98,44,1210,1106,2316,23,0,0.0,3.5217392,39,1083,1055,2138,0.923143351
1833001,98,44,1210,1106,2316,23,0,0.0,4.521739,40,1228,984,2212,0.955094991
1833001,98,44,1210,1106,2316,23,0,0.0,5.521739,42,1397,876,2273,0.981433506
1834001,114,30,645,1050,1695,20,0,0.1,0.95,24,967,544,1511,0.891445428
1834002,114,30,645,1050,1695,20,0,0.0,1.0,28,792,819,1611,0.950442478
1834003,114,30,645,1050,1695,20,0,0.0,1.05,24,397,1088,1485,0.876106195
1834004,114,30,645,1050,1695,20,0,0.0,1.0,23,487,897,1384,0.816519174
1834005,114,30,645,1050,1695,20,0,0.0,0.95,24,406,1067,1473,0.869026549
1834006,114,30,645,1050,1695,20,0,0.05,0.95,26,527,1043,1570,0.926253687
1834007,114,30,645,1050,1695,20,0,0.05,0.95,23,474,966,1440,0.849557522
1834008,114,30,645,1050,1695,20,0,0.0,1.0,23,429,969,1398,0.824778761
1834009,114,30,645,1050,1695,20,0,0.05,0.95,25,666,862,1528,0.901474926
1834010,114,30,645,1050,1695,20,0,0.1,0.9,24,700,816,1516,0.89439528
1834011,114,30,645,1050,1695,20,0,0.15,0.85,21,597,705,1302,0.768141593
1834012,114,30,645,1050,1695,20,0,0.1,0.9,23,439,1032,1471,0.867846608
1834014,110,3,90,120,210,2,0,0.0,0.5,1,50,50,100,0.476190476
1835001,110,3,75,105,180,2,0,0.0,2.0,3,68,112,180,1.0
1837001,112,13,260,416,676,10,1,0.0,0.0,14,532,118,650,0.961538462
1837001,112,13,260,416,676,10,1,0.0,1.0,14,740,-68,672,0.99408284
1837001,112,13,260,416,676,10,1,0.0,2.0,13,313,319,632,0.934911243
1837002,112,13,260,416,676,10,1,0.0,0.0,14,212,445,657,0.971893491
1837002,112,13,260,416,676,10,1,0.0,1.0,13,292,375,667,0.986686391
1837002,112,13,260,416,676,10,1,0.0,2.0,8,162,295,457,0.676035503
1837003,112,13,260,416,676,10,1,0.0,0.0,11,398,151,549,0.812130178
1837003,112,13,260,416,676,10,1,0.0,1.0,13,110,537,647,0.957100592
1837003,112,13,260,416,676,10,1,0.0,2.0,12,93,479,572,0.846153846
1837004,112,13,260,416,676,10,1,0.0,0.0,13,-790,1410,620,0.917159763
1837004,112,13,260,416,676,10,1,0.0,1.0,9,-384,890,506,0.74852071
1837004,112,13,260,416,676,10,1,0.0,2.0,10,-744,1231,487,0.720414201
1837005,112,13,260,416,676,10,1,0.0,0.0,13,284,362,646,0.955621302
1837005,112,13,260,416,676,10,1,0.0,1.0,15,225,435,660,0.976331361
1837005,112,13,260,416,676,10,1,0.0,2.0,12,287,276,563,0.832840237
1837006,107,9,225,303,528,7,0,0.0,0.0,7,-160,574,414,0.784090909
1837006,108,12,270,366,636,9,0,0.0,0.7777778,12,132,444,576,0.905660377
1837006,112,13,260,416,676,10,1,0.0,1.6,13,11,633,644,0.952662722
1838001,120,11,165,275,440,10,0,0.0,1.8,7,176,120,296,0.672727273
1838002,120,11,165,275,440,10,0,0.0,2.0,11,355,35,390,0.886363636
1840001,100,9,234,234,468,7,0,0.0,3.0,7,326,98,424,0.905982906
1843001,112,13,260,416,676,10,1,0.0,10.5,9,195,318,513,0.75887574
1844001,112,13,260,416,676,10,1,0.1,7.3,12,55,534,589,0.871301775
1844002,112,13,260,416,676,10,1,0.1,7.3,11,348,255,603,0.892011834
1844003,112,13,260,416,676,10,1,0.2,7.7,10,459,76,535,0.791420118
1844004,112,13,260,416,676,10,1,0.3,8.5,15,559,101,660,0.976331361
1845001,124,15,375,585,960,10,0,0.2,0.8,14,180,758,938,0.977083333
1845002,124,15,375,585,960,10,0,0.0,1.0,15,318,642,960,1.0
1845004,124,15,375,585,960,10,0,0.0,0.9,15,521,439,960,1.0
1847001,100,16,440,440,880,32,0,0.0,8.40625,10,314,296,610,0.693181818
1848001,100,9,234,234,468,7,0,0.0,4.0,8,374,84,458,0.978632479
1852001,110,11,220,330,550,8,0,0.125,0.875,6,234,210,444,0.807272727
1852002,100,6,192,192,384,5,0,0.2,0.8,1,-154,250,96,0.25
1854001,65,13,780,390,1170,10,0,2.0,8.0,13,484,626,1110,0.948717949
1854001,65,13,780,390,1170,10,0,2.0,9.0,13,283,857,1140,0.974358974
1854002,65,13,780,390,1170,10,0,2.8,6.9,13,145,965,1110,0.948717949
1854002,65,13,780,390,1170,10,0,2.8,7.9,12,493,612,1105,0.944444444
1854003,57,6,438,207,645,5,0,2.4,7.6,5,76,469,545,0.84496124
1854003,57,6,438,207,645,5,0,2.4,8.6,5,105,435,540,0.837209302
1855001,96,10,155,235,390,10,0,0.1,2.3,10,200,103,303,0.776923077
1855001,96,10,155,235,390,10,0,0.1,3.3,12,119,253,372,0.953846154
1855002,96,10,155,235,390,10,0,0.3,2.5,11,59,302,361,0.925641026
1855002,96,10,155,235,390,10,0,0.3,3.5,9,219,139,358,0.917948718
1855003,96,10,155,235,390,10,0,0.6,1.4,8,108,161,269,0.68974359
1855003,96,10,155,235,390,10,0,0.6,2.4,10,250,90,340,0.871794872
1855004,96,10,155,235,390,10,0,0.3,1.7,10,109,245,354,0.907692308
1855004,96,10,155,235,390,10,0,0.3,2.7,12,7,354,361,0.925641026
1855005,96,10,155,235,390,10,0,0.7,1.3,11,-167,530,363,0.930769231
1855005,96,10,155,235,390,10,0,0.7,2.3,11,121,224,345,0.884615385
1856001,78,24,600,300,900,16,0,0.1875,1.9375,11,-16,591,575,0.638888889
1856002,78,24,600,300,900,16,0,0.0625,1.9375,13,89,592,681,0.756666667
1856003,78,24,600,300,900,16,0,0.0,2.125,11,106,502,608,0.675555556
1856004,78,24,600,300,900,16,0,0.0,2.0625,12,170,474,644,0.715555556
1856005,78,24,600,300,900,16,0,0.3125,1.8125,12,170,474,644,0.715555556
1856006,78,24,600,300,900,16,0,0.125,2.0,13,-101,771,670,0.744444444
1856007,78,24,600,300,900,16,0,0.125,2.0625,14,31,670,701,0.778888889
1856008,78,24,600,300,900,16,0,0.3125,1.9375,14,216,469,685,0.761111111
1856009,78,24,600,300,900,16,0,0.3125,1.9375,11,153,469,622,0.691111111
1856010,78,24,600,300,900,16,0,1.0625,1.375,16,28,733,761,0.845555556
1856011,79,21,525,294,819,14,0,0.35714287,1.7142857,12,67,523,590,0.72039072
1857001,112,13,260,416,676,10,1,0.0,1.0,10,22,556,578,0.855029586
1857002,112,13,260,416,676,10,1,0.0,1.0,10,506,60,566,0.837278107
1857003,112,13,260,416,676,10,1,0.0,1.0,7,56,337,393,0.581360947
1858001,5,36,75,75,150,45,0,0.0,0.8,42,-9,102,93,0.62
1861001,120,6,105,195,300,17,0,0.0,4.0,7,120,86,206,0.686666667
1861001,120,6,105,195,300,17,0,0.0,5.0,8,233,17,250,0.833333333
1861001,120,6,105,195,300,17,0,0.0,6.0,6,103,154,257,0.856666667
1861001,120,6,105,195,300,17,0,0.0,7.0,5,48,202,250,0.833333333
1862001,113,28,658,1008,1666,28,0,0.0,2.0,24,690,762,1452,0.871548619
1863001,110,65,1504,2064,3568,50,0,0.3,3.08,71,83,3358,3441,0.96440583
1863001,110,65,1504,2064,3568,50,0,0.3,4.08,68,1106,2322,3428,0.960762332
1863001,110,65,1504,2064,3568,50,0,0.3,5.08,61,1734,1385,3119,0.874159193
1863003,112,35,843,1133,1976,24,0,0.125,3.125,26,1312,193,1505,0.761639676
1863003,112,38,897,1209,2106,26,0,0.115384616,4.076923,30,567,1201,1768,0.839506173
1865001,95,5,125,125,250,2,0,0.0,3.0,5,44,206,250,1.0
1867001,112,13,260,416,676,10,1,0.0,3.0,14,177,492,669,0.98964497
1867002,108,12,270,366,636,9,0,0.0,3.0,12,101,535,636,1.0
1868001,107,8,176,232,408,6,0,0.0,0.8333333,5,99,201,300,0.735294118
1868002,107,8,176,232,408,6,0,0.0,0.8333333,4,59,141,200,0.490196078
1868003,107,8,176,232,408,6,0,2.0,1.3333334,5,-69,391,322,0.789215686
1868004,99,6,180,174,354,5,0,0.0,1.0,4,125,147,272,0.768361582
1873001,103,25,725,725,1450,10,0,0.6,2.4,25,636,814,1450,1.0
1873001,103,25,725,725,1450,10,0,0.6,3.4,25,633,817,1450,1.0
1873001,103,25,725,725,1450,10,0,0.6,4.4,24,382,1052,1434,0.988965517
1873002,103,25,725,725,1450,10,0,0.6,2.1,21,666,644,1310,0.903448276
1873002,103,25,725,725,1450,10,0,0.6,3.1,21,338,976,1314,0.906206897
1873002,103,25,725,725,1450,10,0,0.6,4.1,20,791,479,1270,0.875862069
1873003,103,25,725,725,1450,10,0,0.3,2.7,24,820,610,1430,0.986206897
1873003,103,25,725,725,1450,10,0,0.3,3.7,25,419,1031,1450,1.0
1873003,103,25,725,725,1450,10,0,0.3,4.7,24,815,611,1426,0.983448276
1873004,98,15,540,468,1008,7,0,0.0,2.5714285,15,227,767,994,0.986111111
1873004,103,20,600,600,1200,8,0,0.0,3.125,17,729,399,1128,0.94
1873004,103,20,600,600,1200,8,0,0.0,4.125,15,352,708,1060,0.883333333
1876001,112,13,260,416,676,10,1,0.0,14.0,6,319,109,428,0.633136095
1876002,112,13,260,416,676,10,1,0.0,11.6,7,457,16,473,0.699704142
1876003,112,9,180,288,468,6,0,0.0,13.0,4,-11,293,282,0.602564103
1878001,99,24,672,948,1620,16,0,0.0,1.9375,23,521,1064,1585,0.978395062
1878002,99,24,672,948,1620,16,0,0.0625,1.9375,21,505,993,1498,0.924691358
1878003,99,24,672,948,1620,16,0,0.0,1.9375,22,645,910,1555,0.959876543
1878004,99,24,672,948,1620,16,0,0.125,1.8125,24,560,1060,1620,1.0
1878005,99,24,672,948,1620,16,0,0.0,1.9375,23,551,1048,1599,0.987037037
1878006,99,24,672,948,1620,16,0,0.1875,1.8125,21,744,759,1503,0.927777778
1878007,99,24,672,948,1620,16,0,0.1875,2.125,22,267,1297,1564,0.965432099
1879001,96,10,155,235,390,10,0,0.0,4.0,9,182,176,358,0.917948718
1879002,96,10,155,235,390,10,0,0.0,4.4,8,32,272,304,0.779487179
1879003,96,10,155,235,390,10,0,0.5,4.7,9,59,274,333,0.853846154
1879004,96,10,155,235,390,10,0,0.0,4.0,10,101,220,321,0.823076923
1879004,96,10,155,235,390,10,0,0.0,5.0,1,5,52,57,0.146153846
1879005,96,10,155,235,390,10,0,0.4,4.3,8,86,232,318,0.815384615
1879006,94,6,123,159,282,6,0,0.0,4.0,5,169,22,191,0.677304965
1880001,72,9,144,315,459,10,0,0.2,1.8,12,48,314,362,0.788671024
1880001,72,9,144,315,459,10,0,0.2,2.8,12,-94,496,402,0.875816993
1880002,72,9,144,315,459,10,0,0.3,1.6,12,220,132,352,0.766884532
1880002,72,9,144,315,459,10,0,0.3,2.6,11,-220,454,234,0.509803922
1883001,78,13,312,156,468,10,0,1.5,7.8,7,50,304,354,0.756410256
1883001,78,13,312,156,468,10,0,1.5,8.8,5,53,235,288,0.615384615
1883002,78,13,312,156,468,10,0,0.4,9.5,8,31,305,336,0.717948718
1883002,78,13,312,156,468,10,0,0.4,10.5,7,51,289,340,0.726495726
1883003,78,13,312,156,468,10,0,0.4,8.9,6,221,101,322,0.688034188
1883003,78,13,312,156,468,10,0,0.4,9.9,7,58,310,368,0.786324786
1883004,78,13,312,156,468,10,0,0.9,9.7,7,98,246,344,0.735042735
1883004,78,13,312,156,468,10,0,0.9,10.7,6,72,200,272,0.581196581
1883005,78,13,312,156,468,10,0,1.7,7.7,7,41,289,330,0.705128205
1883005,78,13,312,156,468,10,0,1.7,8.7,6,8,266,274,0.585470085
1884001,112,13,260,416,676,10,1,0.0,0.0,12,228,436,664,0.982248521
1884002,112,13,260,416,676,10,1,0.0,0.0,13,392,275,667,0.986686391
1884003,112,13,260,416,676,10,1,0.0,0.0,14,263,404,667,0.986686391
1884004,108,12,270,366,636,9,0,0.0,0.0,12,247,379,626,0.98427673
1885001,99,12,414,432,846,9,0,4.888889,3.1111112,6,223,234,457,0.540189125
1887001,108,9,198,270,468,10,0,0.8,17.2,8,239,147,386,0.824786325
1887001,108,9,198,270,468,10,0,0.8,18.2,7,153,243,396,0.846153846
1887001,108,9,198,270,468,10,0,0.8,19.2,8,143,198,341,0.728632479
1887002,108,9,198,270,468,10,0,1.8,12.6,8,255,185,440,0.94017094
1887002,108,9,198,270,468,10,0,1.8,13.6,8,150,203,353,0.754273504
1887002,108,9,198,270,468,10,0,1.8,14.6,7,148,217,365,0.77991453
1887003,108,9,198,270,468,10,0,0.8,16.6,9,147,300,447,0.955128205
1887003,108,9,198,270,468,10,0,0.8,17.6,6,102,290,392,0.837606838
1887003,108,9,198,270,468,10,0,0.8,18.6,7,103,318,421,0.89957265
1888001,100,51,1325,1275,2600,26,0,0.0,0.0,40,226,1940,2166,0.833076923
1888001,100,51,1325,1275,2600,26,0,0.0,1.0,42,802,1533,2335,0.898076923
1889001,112,13,260,416,676,10,1,0.0,1.0,11,287,342,629,0.930473373
1889001,112,13,260,416,676,10,1,0.0,2.0,13,233,422,655,0.968934911
1889002,112,13,260,416,676,10,1,0.0,1.0,10,443,95,538,0.795857988
1889002,112,13,260,416,676,10,1,0.0,2.0,12,-14,626,612,0.905325444
1889003,112,13,260,416,676,10,1,0.0,1.0,13,876,-229,647,0.957100592
1889003,112,13,260,416,676,10,1,0.0,2.0,12,-44,635,591,0.874260355
1889004,112,13,260,416,676,10,1,0.0,1.0,11,201,392,593,0.877218935
1889004,112,13,260,416,676,10,1,0.0,2.0,12,198,402,600,0.887573964
1889005,112,13,260,416,676,10,1,0.0,1.0,10,366,247,613,0.906804734
1889005,112,13,260,416,676,10,1,0.0,2.0,12,164,388,552,0.816568047
1889006,112,13,260,416,676,10,1,0.0,1.0,7,259,180,439,0.649408284
1889006,112,13,260,416,676,10,1,0.0,2.0,8,277,205,482,0.713017751
1889007,112,13,260,416,676,10,1,0.0,1.0,11,117,444,561,0.829881657
1889007,112,13,260,416,676,10,1,0.0,2.0,10,108,441,549,0.812130178
1889008,112,13,260,416,676,10,1,0.1,0.9,12,493,119,612,0.905325444
1889008,112,13,260,416,676,10,1,0.1,1.9,13,519,119,638,0.943786982
1889009,112,13,260,416,676,10,1,0.0,0.9,10,112,403,515,0.76183432
1889009,112,13,260,416,676,10,1,0.0,1.9,11,211,416,627,0.927514793
1889010,112,13,260,416,676,10,1,0.0,1.0,10,139,389,528,0.781065089
1889010,112,13,260,416,676,10,1,0.0,2.0,10,-53,522,469,0.693786982
1889011,112,13,260,416,676,10,1,0.0,1.0,12,209,421,630,0.931952663
1889011,112,13,260,416,676,10,1,0.0,2.0,12,159,421,580,0.857988166
1889012,112,13,260,416,676,10,1,0.1,0.9,12,210,437,647,0.957100592
1889012,112,13,260,416,676,10,1,0.1,1.9,13,304,349,653,0.965976331
1889013,112,13,260,416,676,10,1,0.0,1.0,6,-380,763,383,0.566568047
1889013,112,13,260,416,676,10,1,0.0,2.0,9,87,438,525,0.776627219
1889014,112,13,260,416,676,10,1,0.1,0.9,13,398,235,633,0.936390533
1889014,112,13,260,416,676,10,1,0.1,1.9,12,303,276,579,0.856508876
1889015,112,13,260,416,676,10,1,0.1,0.9,10,355,111,466,0.689349112
1889015,112,13,260,416,676,10,1,0.1,1.9,10,383,66,449,0.664201183
1889016,112,13,260,416,676,10,1,0.1,0.9,6,150,255,405,0.599112426
1889016,112,13,260,416,676,10,1,0.1,1.9,10,357,157,514,0.76035503
1889017,112,13,260,416,676,10,1,0.0,1.0,12,465,160,625,0.924556213
1889017,112,13,260,416,676,10,1,0.0,2.0,9,455,27,482,0.713017751
1889018,112,13,260,416,676,10,1,0.0,1.0,7,192,172,364,0.538461538
1889018,112,13,260,416,676,10,1,0.0,2.0,10,251,281,532,0.786982249
1889019,112,13,260,416,676,10,1,0.1,0.9,11,250,354,604,0.893491124
1889019,112,13,260,416,676,10,1,0.1,1.9,10,175,402,577,0.853550296
1889020,112,13,260,416,676,10,1,0.0,1.0,13,658,-5,653,0.965976331
1889020,112,13,260,416,676,10,1,0.0,2.0,9,178,284,462,0.683431953
1889021,112,13,260,416,676,10,1,0.0,1.0,10,242,305,547,0.809171598
1889021,112,13,260,416,676,10,1,0.0,2.0,11,189,350,539,0.797337278
1889022,112,13,260,416,676,10,1,0.1,0.9,11,337,230,567,0.838757396
1889022,112,13,260,416,676,10,1,0.1,1.9,13,293,363,656,0.970414201
1889023,112,13,260,416,676,10,1,0.0,1.0,9,403,155,558,0.825443787
1889023,112,13,260,416,676,10,1,0.0,2.0,12,449,158,607,0.897928994
1889024,112,13,260,416,676,10,1,0.0,1.0,10,445,123,568,0.840236686
1889024,112,13,260,416,676,10,1,0.0,2.0,11,417,219,636,0.940828402
1889025,112,13,260,416,676,10,1,0.0,1.0,12,372,265,637,0.942307692
1889025,112,13,260,416,676,10,1,0.0,2.0,11,235,383,618,0.914201183
1889026,112,13,260,416,676,10,1,0.0,1.0,9,123,387,510,0.75443787
1889026,112,13,260,416,676,10,1,0.0,2.0,11,29,563,592,0.875739645
1889027,112,13,260,416,676,10,1,0.0,1.0,12,369,251,620,0.917159763
1889027,112,13,260,416,676,10,1,0.0,2.0,11,227,247,474,0.701183432
1889028,112,13,260,416,676,10,1,0.0,1.0,14,429,230,659,0.974852071
1889028,112,13,260,416,676,10,1,0.0,2.0,13,338,323,661,0.977810651
1889029,112,13,260,416,676,10,1,0.0,1.0,12,497,134,631,0.933431953
1889029,112,13,260,416,676,10,1,0.0,2.0,11,350,184,534,0.789940828
1889030,112,13,260,416,676,10,1,0.0,1.0,10,292,251,543,0.803254438
1889030,112,13,260,416,676,10,1,0.0,2.0,12,506,91,597,0.883136095
1889031,112,13,260,416,676,10,1,0.0,1.0,9,147,332,479,0.708579882
1889031,112,13,260,416,676,10,1,0.0,2.0,12,106,531,637,0.942307692
1889032,112,13,260,416,676,10,1,0.0,1.0,12,433,107,540,0.798816568
1889032,112,13,260,416,676,10,1,0.0,2.0,9,317,175,492,0.727810651
1889033,112,13,260,416,676,10,1,0.0,1.0,12,262,299,561,0.829881657
1889033,112,13,260,416,676,10,1,0.0,2.0,10,-4,524,520,0.769230769
1889034,112,13,260,416,676,10,1,0.0,1.0,12,289,312,601,0.889053254
1889034,112,13,260,416,676,10,1,0.0,2.0,12,271,275,546,0.807692308
1889035,112,13,260,416,676,10,1,0.0,1.0,14,608,61,669,0.98964497
1889035,112,13,260,416,676,10,1,0.0,2.0,10,265,285,550,0.813609467
1889036,112,13,260,416,676,10,1,0.0,1.0,12,235,372,607,0.897928994
1889036,112,13,260,416,676,10,1,0.0,2.0,12,340,292,632,0.934911243
1889037,112,13,260,416,676,10,1,0.0,1.0,14,187,473,660,0.976331361
1889037,112,13,260,416,676,10,1,0.0,2.0,11,78,479,557,0.823964497
1889038,112,13,260,416,676,10,1,0.0,1.0,14,196,476,672,0.99408284
1889038,112,13,260,416,676,10,1,0.0,2.0,11,217,341,558,0.825443787
1889040,112,13,260,416,676,10,1,0.1,0.9,13,557,102,659,0.974852071
1889040,112,13,260,416,676,10,1,0.1,1.9,9,112,355,467,0.690828402
1889041,112,13,260,416,676,10,1,0.2,0.8,11,311,202,513,0.75887574
1889041,112,13,260,416,676,10,1,0.2,1.8,2,53,83,136,0.201183432
1891001,247,6,168,597,765,10,0,0.5,10.5,6,-9,704,695,0.908496732
1891002,247,6,168,597,765,10,0,0.3,10.7,4,167,519,686,0.896732026
1891003,247,6,168,597,765,10,0,0.5,10.5,6,164,601,765,1.0
1892001,95,10,135,225,360,10,0,0.1,1.9,10,126,194,320,0.888888889
1892001,95,10,135,225,360,10,0,0.1,2.9,10,27,288,315,0.875
1892002,95,10,135,225,360,10,0,0.7,2.3,10,144,130,274,0.761111111
1892002,95,10,135,225,360,10,0,0.7,3.3,10,184,20,204,0.566666667
1892003,95,10,135,225,360,10,0,0.1,1.9,12,42,294,336,0.933333333
1892003,95,10,135,225,360,10,0,0.1,2.9,9,190,86,276,0.766666667
1892004,95,10,135,225,360,10,0,0.2,1.8,10,51,248,299,0.830555556
1892004,95,10,135,225,360,10,0,0.2,2.8,7,84,122,206,0.572222222
1892005,95,10,135,225,360,10,0,0.6,1.4,11,134,177,311,0.863888889
1892005,95,10,135,225,360,10,0,0.6,2.4,8,78,182,260,0.722222222
1893001,133,39,2535,1755,4290,26,0,0.0,0.0,36,2585,1489,4074,0.94965035
1893001,133,39,2535,1755,4290,26,0,0.0,1.0,35,2655,1401,4056,0.945454545
1893001,133,39,2535,1755,4290,26,0,0.0,2.0,37,2654,1525,4179,0.974125874
1895001,78,13,312,156,468,10,0,1.0,4.1,6,82,220,302,0.645299145
1895001,78,13,312,156,468,10,0,1.0,5.1,9,7,397,404,0.863247863
1895002,78,13,312,156,468,10,0,0.3,3.8,7,34,308,342,0.730769231
1895002,78,13,312,156,468,10,0,0.3,4.8,6,-56,362,306,0.653846154
1895003,78,13,312,156,468,10,0,0.9,3.1,7,1,333,334,0.713675214
1895003,78,13,312,156,468,10,0,0.9,4.1,4,48,190,238,0.508547009
1895004,78,13,312,156,468,10,0,0.2,3.0,6,-2,292,290,0.61965812
1895004,78,13,312,156,468,10,0,0.2,4.0,8,32,368,400,0.854700855
1895005,78,13,312,156,468,10,0,0.7,4.3,6,79,255,334,0.713675214
1895005,78,13,312,156,468,10,0,0.7,5.3,7,76,278,354,0.756410256
1895006,78,13,312,156,468,10,0,1.6,2.9,8,-22,400,378,0.807692308
1895006,78,13,312,156,468,10,0,1.6,3.9,6,112,178,290,0.61965812
1896001,96,7,198,169,367,15,0,0.0,2.0,5,308,-95,213,0.580381471
1898001,116,17,306,578,884,12,0,0.0,1.0,14,132,668,800,0.904977376
1898002,116,17,306,578,884,12,0,0.0,1.0,17,408,472,880,0.995475113
1898003,112,15,330,510,840,11,0,0.0,0.8181818,12,647,79,726,0.864285714
1900001,100,25,650,650,1300,10,0,0.0,0.0,23,137,1115,1252,0.963076923
1900002,100,25,650,650,1300,10,0,0.0,0.0,23,583,681,1264,0.972307692
1900003,100,25,650,650,1300,10,0,0.0,0.0,20,-199,1353,1154,0.887692308
1900004,100,25,650,650,1300,10,0,0.0,0.0,25,-143,1443,1300,1.0
1902001,91,9,162,189,351,9,0,0.0,0.0,7,154,144,298,0.849002849
1902001,91,9,162,189,351,9,0,0.0,1.0,6,126,133,259,0.737891738
1902001,91,9,162,189,351,9,0,0.0,2.0,8,166,148,314,0.894586895
1904001,110,21,420,630,1050,15,0,1.0666667,2.2666667,10,177,468,645,0.614285714
1904002,110,21,420,630,1050,15,0,1.0666667,2.0666666,15,530,349,879,0.837142857
1904003,110,21,420,630,1050,15,0,1.0666667,2.7333333,12,354,310,664,0.632380952
1906001,107,4,100,126,226,10,0,0.0,2.5,3,64,16,80,0.353982301
1906002,107,4,100,126,226,10,0,0.0,3.6,4,-30,181,151,0.668141593
1906003,107,4,100,126,226,10,0,0.0,3.0,5,111,99,210,0.92920354
1906004,107,4,100,126,226,10,0,0.0,3.5,2,0,79,79,0.349557522
1906005,107,4,100,126,226,10,0,0.0,3.4,3,125,71,196,0.867256637
1907001,100,2,50,50,100,4,0,0.0,1.0,2,67,33,100,1.0
1909001,115,51,1887,1887,3774,34,0,0.0,2.0294118,49,1821,1881,3702,0.980922099
1911001,112,13,260,416,676,10,1,0.2,2.7,9,534,26,560,0.828402367
1911002,112,13,260,416,676,10,1,0.5,2.5,10,452,113,565,0.835798817
1911003,112,13,260,416,676,10,1,0.2,2.6,11,390,217,607,0.897928994
1911004,112,13,260,416,676,10,1,0.0,2.9,8,105,397,502,0.74260355
1911005,112,13,260,416,676,10,1,0.2,2.7,12,-247,838,591,0.874260355
1911006,112,13,260,416,676,10,1,0.2,2.6,5,309,91,400,0.591715976
1911007,112,13,260,416,676,10,1,0.2,2.7,6,326,125,451,0.667159763
1911008,97,3,114,111,225,3,0,0.33333334,2.6666667,3,198,22,220,0.977777778
1912001,112,13,260,416,676,10,1,0.3,1.7,12,306,315,621,0.918639053
1912002,112,13,260,416,676,10,1,0.5,2.0,13,271,395,666,0.985207101
1912003,112,13,260,416,676,10,1,0.3,1.7,12,307,325,632,0.934911243
1912004,112,13,260,416,676,10,1,0.4,2.6,10,234,351,585,0.865384615
1913001,108,29,1384,870,2254,25,0,0.0,3.0,27,709,1483,2192,0.972493345
1913001,108,29,1384,870,2254,25,0,0.0,4.0,31,958,1218,2176,0.965394854
1913001,108,29,1384,870,2254,25,0,0.0,5.0,25,1137,1002,2139,0.948979592
1913001,108,29,1384,870,2254,25,0,0.0,6.0,27,1294,865,2159,0.957852706
1913001,108,29,1384,870,2254,25,0,0.0,7.0,28,1181,970,2151,0.954303461
1914001,112,13,260,416,676,10,1,0.0,6.0,12,218,398,616,0.911242604
1914002,112,13,260,416,676,10,1,0.3,6.2,13,470,206,676,1.0
1914003,112,13,260,416,676,10,1,0.2,5.4,13,-105,768,663,0.980769231
1916001,124,15,375,585,960,10,0,0.0,1.0,13,234,682,916,0.954166667
1916002,124,15,375,585,960,10,0,0.3,0.7,14,200,732,932,0.970833333
1916003,124,15,375,585,960,10,0,0.0,1.0,13,210,646,856,0.891666667
1916005,124,15,375,585,960,10,0,0.0,1.0,13,76,850,926,0.964583333
1916006,124,15,375,585,960,10,0,0.1,0.9,14,582,361,943,0.982291667
1916007,124,15,375,585,960,10,0,0.2,0.8,13,271,643,914,0.952083333
1917001,112,13,260,416,676,10,1,3.0,0.0,13,320,310,630,0.931952663
1917001,112,13,260,416,676,10,1,3.0,1.0,14,369,292,661,0.977810651
1917001,112,13,260,416,676,10,1,3.0,2.0,9,267,300,567,0.838757396
1917002,112,13,260,416,676,10,1,3.0,0.0,9,59,456,515,0.76183432
1917002,112,13,260,416,676,10,1,3.0,1.0,14,129,522,651,0.963017751
1917002,112,13,260,416,676,10,1,3.0,2.0,5,63,301,364,0.538461538
1918001,112,13,260,416,676,10,1,0.0,4.3,9,325,176,501,0.74112426
1918002,112,13,260,416,676,10,1,0.0,3.6,10,81,497,578,0.855029586
1918003,112,13,260,416,676,10,1,0.0,4.3,13,84,571,655,0.968934911
1918004,112,13,260,416,676,10,1,0.0,3.9,9,141,402,543,0.803254438
1918005,112,13,260,416,676,10,1,0.0,3.1,12,464,143,607,0.897928994
1919001,100,7,170,170,340,14,0,0.0,5.0,7,259,81,340,1.0
1920001,105,12,276,330,606,9,0,0.0,1.0,10,47,445,492,0.811881188
1920002,105,9,225,285,510,7,0,0.0,1.0,9,69,411,480,0.941176471
1922002,112,13,260,416,676,10,1,0.0,1.0,12,-16,574,558,0.825443787
1922003,112,13,260,416,676,10,1,0.0,1.0,15,-154,814,660,0.976331361
1924001,125,26,650,325,975,32,0,0.90625,5.65625,19,535,201,736,0.754871795
1924001,125,26,650,325,975,32,0,0.90625,6.65625,26,546,291,837,0.858461538
1925001,112,13,260,416,676,10,1,0.0,2.0,10,362,227,589,0.871301775
1925001,112,13,260,416,676,10,1,0.0,3.0,14,364,303,667,0.986686391
1925002,112,13,260,416,676,10,1,0.0,2.0,7,186,282,468,0.692307692
1925002,112,13,260,416,676,10,1,0.0,3.0,7,228,234,462,0.683431953
1926001,111,4,132,156,288,9,0,0.0,4.0,2,1,131,132,0.458333333
1926001,111,4,132,156,288,9,0,0.0,5.0,4,-149,413,264,0.916666667
1926001,111,4,132,156,288,9,0,0.0,6.0,3,99,99,198,0.6875
1926001,111,4,132,156,288,9,0,0.0,7.0,3,36,142,178,0.618055556
1928001,78,13,312,156,468,10,0,0.8,10.7,10,219,179,398,0.85042735
1928001,78,13,312,156,468,10,0,0.8,11.7,9,118,240,358,0.764957265
1928002,78,13,312,156,468,10,0,0.7,6.8,9,211,159,370,0.790598291
1928002,78,13,312,156,468,10,0,0.7,7.8,12,287,125,412,0.88034188
1928003,78,13,312,156,468,10,0,1.6,8.4,11,221,213,434,0.927350427
1928003,78,13,312,156,468,10,0,1.6,9.4,10,113,235,348,0.743589744
1928004,78,13,312,156,468,10,0,1.5,10.5,11,137,237,374,0.799145299
1928004,78,13,312,156,468,10,0,1.5,11.5,8,169,159,328,0.700854701
1929001,112,13,260,416,676,10,1,0.0,0.0,12,297,276,573,0.847633136
1929002,112,13,260,416,676,10,1,0.0,0.0,11,-86,647,561,0.829881657
1929003,112,13,260,416,676,10,1,0.0,0.0,10,475,70,545,0.806213018
1931001,116,17,306,578,884,12,0,0.0,2.8333333,18,137,745,882,0.997737557
1932001,112,13,260,416,676,10,1,0.0,1.0,13,261,403,664,0.982248521
1932002,112,13,260,416,676,10,1,0.0,1.0,11,327,320,647,0.957100592
1932003,112,13,260,416,676,10,1,0.0,1.0,11,173,463,636,0.940828402
1932004,112,13,260,416,676,10,1,0.0,1.0,11,361,274,635,0.939349112
1932005,112,13,260,416,676,10,1,0.0,1.0,13,398,248,646,0.955621302
1932006,112,13,260,416,676,10,1,0.0,1.0,12,28,596,624,0.923076923
1932007,112,13,260,416,676,10,1,0.1,0.9,11,289,308,597,0.883136095
1932008,112,13,260,416,676,10,1,0.2,0.8,9,354,204,558,0.825443787
1932009,112,13,260,416,676,10,1,0.0,1.0,9,290,258,548,0.810650888
1932010,112,13,260,416,676,10,1,0.0,1.0,10,306,290,596,0.881656805
1932011,112,13,260,416,676,10,1,0.0,1.0,12,364,239,603,0.892011834
1932012,112,13,260,416,676,10,1,0.0,1.0,12,160,480,640,0.946745562
1932013,112,13,260,416,676,10,1,0.1,0.9,13,410,227,637,0.942307692
1932014,112,13,260,416,676,10,1,0.0,1.0,12,325,321,646,0.955621302
1932015,112,13,260,416,676,10,1,0.0,1.0,11,201,456,657,0.971893491
1932016,112,13,260,416,676,10,1,0.0,1.0,11,361,235,596,0.881656805
1932017,112,13,260,416,676,10,1,0.0,1.0,12,440,198,638,0.943786982
1935001,116,17,306,578,884,12,0,1.5833334,4.4166665,15,507,341,848,0.959276018
1935001,116,17,306,578,884,12,0,1.5833334,5.4166665,16,496,380,876,0.990950226
1935002,116,17,306,578,884,12,0,1.0,5.0,15,595,249,844,0.954751131
1935002,116,17,306,578,884,12,0,1.0,6.0,15,457,399,856,0.968325792
1936001,100,51,1275,1275,2550,35,0,0.0,1.0285715,50,1154,1369,2523,0.989411765
1936002,100,51,1275,1275,2550,35,0,0.0,0.85714287,42,1244,915,2206,0.865098039
1937001,94,12,342,264,606,9,0,3.0,13.444445,12,245,347,592,0.97689769
1937001,94,12,342,264,606,9,0,3.0,14.444445,14,125,433,558,0.920792079
1939001,115,30,600,1050,1650,30,0,0.0,1.0,17,348,789,1137,0.689090909
1940001,114,30,645,1050,1695,20,0,0.05,0.95,28,486,1163,1649,0.972861357
1940001,114,30,645,1050,1695,20,0,0.05,1.95,25,789,741,1530,0.902654867
1940002,114,30,645,1050,1695,20,0,0.0,1.0,18,924,304,1228,0.724483776
1940002,114,30,645,1050,1695,20,0,0.0,2.0,28,811,832,1643,0.969321534
1940003,114,30,645,1050,1695,20,0,0.1,0.9,22,712,698,1410,0.831858407
1940003,114,30,645,1050,1695,20,0,0.1,1.9,29,887,782,1669,0.984660767
1940004,114,30,645,1050,1695,20,0,0.0,1.0,26,938,599,1537,0.906784661
1940004,114,30,645,1050,1695,20,0,0.0,2.0,26,753,785,1538,0.907374631
1940005,114,30,645,1050,1695,20,0,0.1,0.9,23,809,684,1493,0.880825959
1940005,114,30,645,1050,1695,20,0,0.1,1.9,28,211,1437,1648,0.972271386
1940006,114,30,645,1050,1695,20,0,0.1,0.9,27,862,731,1593,0.939823009
1940006,114,30,645,1050,1695,20,0,0.1,1.9,24,1236,216,1452,0.856637168
1940007,114,30,645,1050,1695,20,0,0.05,0.95,26,145,1398,1543,0.910324484
1940007,114,30,645,1050,1695,20,0,0.05,1.95,28,499,1133,1632,0.962831858
1940008,114,30,645,1050,1695,20,0,0.25,0.75,24,700,815,1515,0.89380531
1940008,114,30,645,1050,1695,20,0,0.25,1.75,28,958,684,1642,0.968731563
1940009,114,30,645,1050,1695,20,0,0.05,0.95,26,659,892,1551,0.915044248
1940009,114,30,645,1050,1695,20,0,0.05,1.95,26,849,714,1563,0.922123894
1945001,112,13,260,416,676,10,1,0.1,1.7,13,221,416,637,0.942307692
1945002,112,13,260,416,676,10,1,0.2,1.7,14,127,532,659,0.974852071
1947001,112,13,260,416,676,10,1,0.0,4.4,12,-60,702,642,0.949704142
1947002,112,13,260,416,676,10,1,0.0,4.5,12,146,479,625,0.924556213
1947003,112,13,260,416,676,10,1,0.0,4.9,12,188,460,648,0.958579882
1947004,112,13,260,416,676,10,1,0.0,5.0,12,109,533,642,0.949704142
1947005,112,13,260,416,676,10,1,0.0,4.2,14,-965,1614,649,0.960059172
1947006,112,13,260,416,676,10,1,0.0,4.5,11,258,370,628,0.928994083
1947007,112,13,260,416,676,10,1,0.0,4.6,10,86,527,613,0.906804734
1947008,112,13,260,416,676,10,1,0.0,4.6,10,-61,589,528,0.781065089
1947009,112,13,260,416,676,10,1,0.0,4.9,12,300,335,635,0.939349112
1947010,112,13,260,416,676,10,1,0.0,5.0,14,300,356,656,0.970414201
1947011,112,13,260,416,676,10,1,0.0,4.6,13,213,433,646,0.955621302
1947012,112,13,260,416,676,10,1,0.0,5.0,12,-18,647,629,0.930473373
1949001,112,13,260,416,676,10,1,0.0,15.0,10,367,225,592,0.875739645
1949002,112,13,260,416,676,10,1,0.0,12.6,11,555,99,654,0.967455621
1949003,112,9,180,288,468,6,0,0.0,14.0,7,220,220,440,0.94017094
1950001,78,13,312,156,468,10,0,0.1,9.5,10,-10,420,410,0.876068376
1950001,78,13,312,156,468,10,0,0.1,10.5,6,-106,336,230,0.491452991
1950002,78,13,312,156,468,10,0,2.1,8.3,6,31,219,250,0.534188034
1950002,78,13,312,156,468,10,0,2.1,9.3,6,67,205,272,0.581196581
1950003,78,13,312,156,468,10,0,1.2,9.4,7,240,46,286,0.611111111
1950003,78,13,312,156,468,10,0,1.2,10.4,7,82,268,350,0.747863248
1951001,350,11,825,825,1650,8,0,0.0,2.0,15,565,500,1065,0.645454545
1951002,350,11,825,825,1650,8,0,0.0,2.0,7,848,307,1155,0.7
1951003,350,11,825,825,1650,8,0,0.0,2.0,13,-179,1394,1215,0.736363636
1951004,350,11,825,825,1650,8,0,0.0,2.0,13,-649,1729,1080,0.654545455
1951005,297,4,452,238,690,3,0,0.0,2.0,2,-287,767,480,0.695652174
1953001,90,41,820,820,1640,30,0,0.1,0.13333334,38,886,616,1502,0.915853659
1953001,90,41,820,820,1640,30,0,0.1,1.1333333,35,779,684,1463,0.892073171
1953001,90,41,820,820,1640,30,0,0.1,2.1333334,41,808,783,1591,0.970121951
1953001,90,41,820,820,1640,30,0,0.1,3.1333334,36,421,1066,1487,0.906707317
1953002,90,41,820,820,1640,30,0,0.0,0.13333334,32,35,1348,1383,0.843292683
1953002,90,41,820,820,1640,30,0,0.0,1.1333333,39,595,916,1511,0.921341463
1953002,90,41,820,820,1640,30,0,0.0,2.1333334,39,636,866,1502,0.915853659
1953002,90,41,820,820,1640,30,0,0.0,3.1333334,38,699,813,1512,0.92195122
1953003,90,41,820,820,1640,30,0,0.0,0.26666668,35,209,1157,1366,0.832926829
1953003,90,41,820,820,1640,30,0,0.0,1.2666667,37,729,725,1454,0.886585366
1953003,90,41,820,820,1640,30,0,0.0,2.2666667,41,478,1024,1502,0.915853659
1953003,90,41,820,820,1640,30,0,0.0,3.2666667,40,765,750,1515,0.923780488
1953004,90,41,820,820,1640,30,0,0.0,0.0,33,660,712,1372,0.836585366
1953004,90,41,820,820,1640,30,0,0.0,1.0,39,276,1236,1512,0.92195122
1953004,90,41,820,820,1640,30,0,0.0,2.0,34,211,1208,1419,0.865243902
1953004,90,41,820,820,1640,30,0,0.0,3.0,30,439,802,1241,0.756707317
1953005,90,41,820,820,1640,30,0,0.0,0.13333334,36,340,1116,1456,0.887804878
1953005,90,41,820,820,1640,30,0,0.0,1.1333333,41,674,903,1577,0.961585366
1953005,90,41,820,820,1640,30,0,0.0,2.1333334,36,429,996,1425,0.868902439
1953005,90,41,820,820,1640,30,0,0.0,3.1333334,34,487,969,1456,0.887804878
1953006,89,27,594,582,1176,19,0,0.0,0.0,21,776,214,990,0.841836735
1953006,90,30,615,615,1230,20,0,0.0,1.15,26,-366,1519,1153,0.937398374
1953006,90,30,615,615,1230,20,0,0.0,2.15,22,128,867,995,0.808943089
1953006,90,30,615,615,1230,20,0,0.0,3.15,16,-404,1168,764,0.621138211
1954001,117,7,147,231,378,14,0,0.0,3.9285715,6,18,334,352,0.931216931
1954001,117,7,147,231,378,14,0,0.0,4.928571,7,-8,386,378,1.0
1954001,117,7,147,231,378,14,0,0.0,5.928571,7,3,375,378,1.0
1954001,117,7,147,231,378,14,0,0.0,6.928571,7,40,338,378,1.0
1957001,100,25,650,650,1300,10,0,0.0,8.3,21,502,722,1224,0.941538462
1957001,100,25,650,650,1300,10,0,0.0,9.3,17,559,493,1052,0.809230769
1957001,100,25,650,650,1300,10,0,0.0,10.3,9,360,310,670,0.515384615
1958001,112,13,260,416,676,10,1,0.0,0.0,11,441,180,621,0.918639053
1958002,112,13,260,416,676,10,1,0.0,0.0,11,285,285,570,0.843195266
1958003,112,13,260,416,676,10,1,0.0,0.0,12,506,101,607,0.897928994
1959001,110,21,420,630,1050,16,0,0.0,0.3125,20,547,432,979,0.932380952
1959002,110,21,420,630,1050,16,0,0.0,0.0,21,401,580,981,0.934285714
1959004,105,2,65,75,140,2,0,0.0,0.0,3,128,-8,120,0.857142857
1960001,112,13,260,416,676,10,1,2.3,0.7,2,43,137,180,0.266272189
1967001,78,13,312,156,468,10,0,0.6,5.6,6,230,40,270,0.576923077
1967001,78,13,312,156,468,10,0,0.6,6.6,7,301,-1,300,0.641025641
1967001,78,13,312,156,468,10,0,0.6,7.6,2,91,27,118,0.252136752
1967002,78,13,312,156,468,10,0,0.9,5.7,5,235,-15,220,0.47008547
1967002,78,13,312,156,468,10,0,0.9,6.7,8,360,-24,336,0.717948718
1967002,78,13,312,156,468,10,0,0.9,7.7,6,257,29,286,0.611111111
1967003,78,13,312,156,468,10,0,0.5,6.5,9,282,112,394,0.841880342
1967003,78,13,312,156,468,10,0,0.5,7.5,9,383,9,392,0.837606838
1967003,78,13,312,156,468,10,0,0.5,8.5,2,110,24,134,0.286324786
1967004,78,13,312,156,468,10,0,1.0,6.2,7,-62,384,322,0.688034188
1967004,78,13,312,156,468,10,0,1.0,7.2,10,298,96,394,0.841880342
1967004,78,13,312,156,468,10,0,1.0,8.2,1,47,11,58,0.123931624
1967005,78,13,312,156,468,10,0,0.6,6.4,10,204,190,394,0.841880342
1967005,78,13,312,156,468,10,0,0.6,7.4,9,212,136,348,0.743589744
1967005,78,13,312,156,468,10,0,0.6,8.4,6,195,105,300,0.641025641
1967006,78,13,312,156,468,10,0,0.5,6.5,8,259,89,348,0.743589744
1967006,78,13,312,156,468,10,0,0.5,7.5,9,325,75,400,0.854700855
1967006,78,13,312,156,468,10,0,0.5,8.5,2,81,33,114,0.243589744
1968001,110,87,3931,3931,7862,38,0,0.0,0.0,84,2454,5109,7563,0.961968965
1969001,112,13,260,416,676,10,1,0.1,2.0,3,12,207,219,0.323964497
1969001,112,13,260,416,676,10,1,0.1,3.0,8,55,411,466,0.689349112
1969001,112,13,260,416,676,10,1,0.1,4.0,11,83,458,541,0.800295858
1969002,112,13,260,416,676,10,1,0.1,2.0,7,357,137,494,0.730769231
1969002,112,13,260,416,676,10,1,0.1,3.0,10,502,123,625,0.924556213
1969002,112,13,260,416,676,10,1,0.1,4.0,11,381,259,640,0.946745562
1970001,110,21,420,630,1050,16,0,0.0,1.3125,21,451,567,1018,0.96952381
1970002,110,21,420,630,1050,16,0,0.0,1.0,19,335,612,947,0.901904762
1970004,108,3,78,102,180,2,0,0.0,1.0,2,96,64,160,0.888888889
1971001,110,21,420,630,1050,16,0,0.0625,2.875,22,442,590,1032,0.982857143
1971002,110,21,420,630,1050,16,0,0.125,2.875,21,457,582,1039,0.98952381
1971003,110,21,420,630,1050,16,0,0.125,2.875,21,448,593,1041,0.991428571
1971004,110,21,420,630,1050,16,0,0.375,2.625,20,369,642,1011,0.962857143
1971005,110,21,420,630,1050,16,0,0.125,2.875,24,405,615,1020,0.971428571
1971006,110,21,420,630,1050,16,0,0.0625,3.25,21,433,573,1006,0.958095238
1971007,110,21,420,630,1050,16,0,0.0625,2.9375,19,374,573,947,0.901904762
1972001,99,9,315,339,654,7,0,2.142857,15.285714,1,146,-49,97,0.148318043
1972001,99,12,414,432,846,9,0,2.5555556,17.222221,4,123,207,330,0.390070922
1972001,99,12,414,432,846,9,0,2.5555556,18.222221,4,300,10,310,0.36643026
1972001,99,12,414,432,846,9,0,2.5555556,19.222221,2,55,127,182,0.215130024
1972001,99,12,414,432,846,9,0,2.5555556,20.222221,4,138,163,301,0.355791962
1972003,92,3,129,110,239,3,0,10.333333,31.333334,1,53,47,100,0.418410042
1972003,92,3,129,110,239,3,0,10.333333,32.333332,3,129,110,239,1.0
1972003,92,3,129,110,239,3,0,10.333333,33.333332,3,135,104,239,1.0
1973001,100,17,442,442,884,15,0,0.06666667,0.93333334,20,607,130,737,0.833710407
1973002,100,17,442,442,884,15,0,0.0,1.0,20,-473,1282,809,0.915158371
1974001,99,33,924,909,1833,23,0,0.0,1.9130435,25,527,979,1506,0.821603928
1974001,99,33,924,909,1833,23,0,0.0,2.9130435,26,688,813,1501,0.818876159
1974001,99,33,924,909,1833,23,0,0.0,3.9130435,25,1017,457,1474,0.804146208
1975001,606,11,3744,3091,6835,14,0,0.0,0.0,13,-2975,8687,5712,0.83569861
1975001,606,11,3744,3091,6835,14,0,5.357143,10.642858,12,1499,4272,5771,0.844330651
1975001,606,11,3744,3091,6835,14,0,5.357143,11.642858,12,1782,4361,6143,0.898756401
1975001,606,11,3744,3091,6835,14,0,5.357143,12.642858,10,2291,3404,5695,0.833211412
1975001,606,11,3744,3091,6835,14,0,5.357143,13.642858,11,2718,3281,5999,0.877688369
1976001,110,11,275,275,550,10,0,0.1,0.1,11,-473,953,480,0.872727273
1976002,110,11,275,275,550,10,0,0.1,0.0,11,22,433,455,0.827272727
1976003,110,11,275,275,550,10,0,0.2,0.4,14,176,309,485,0.881818182
1976004,110,11,275,275,550,10,0,0.1,0.0,11,-70,545,475,0.863636364
1976005,110,11,275,275,550,10,0,0.2,0.3,10,-17,512,495,0.9
1976006,110,11,275,275,550,10,0,0.0,0.3,11,352,138,490,0.890909091
1976007,110,11,275,275,550,10,0,0.1,0.2,14,400,85,485,0.881818182
1976008,110,11,275,275,550,10,0,0.1,0.2,12,275,205,480,0.872727273
1976009,110,11,275,275,550,10,0,0.3,0.0,13,274,246,520,0.945454545
1977001,108,126,2709,3858,6567,100,0,0.0,0.02,141,2469,3639,6108,0.930105071
1977002,108,126,2709,3858,6567,100,0,0.0,0.02,138,3116,2834,5950,0.906045378
1977003,108,126,2709,3858,6567,100,0,0.0,0.01,134,2044,4006,6050,0.921273032
1977004,108,126,2709,3858,6567,100,0,0.04,0.1,125,781,4893,5674,0.864017055
1977005,122,39,857,1677,2534,29,0,0.0,0.03448276,31,606,1418,2024,0.798737174
1979001,101,52,1369,1326,2695,37,0,0.0,2.0,48,1309,1275,2584,0.958812616
1980002,110,3,78,108,186,2,0,0.0,1.0,3,117,69,186,1.0
1981001,100,21,630,630,1260,15,0,0.0,5.5333333,15,287,741,1028,0.815873016
1981001,100,21,630,630,1260,15,0,0.0,6.5333333,16,333,709,1042,0.826984127
1981001,100,21,630,630,1260,15,0,0.0,7.5333333,19,417,711,1128,0.895238095
1983001,112,13,260,416,676,10,1,1.8,5.8,11,208,442,650,0.961538462
1983002,112,13,260,416,676,10,1,0.3,7.5,12,320,307,627,0.927514793
1984001,520,210,51450,51450,102900,42,0,0.0,10.095238,148,62811,19878,82689,0.803586006
1985001,105,153,3632,3850,7482,115,0,0.0,0.0,115,4990,787,5777,0.772119754
1985001,105,153,3632,3850,7482,115,0,0.0,1.0,145,5118,1581,6722,0.898422882
1985001,106,155,3566,4003,7569,116,0,0.0,1.9827586,140,4300,2440,6740,0.890474303
1986001,112,13,260,416,676,10,1,0.4,1.6,10,260,303,563,0.832840237
1986001,112,13,260,416,676,10,1,0.4,2.6,11,182,432,614,0.908284024
1987001,90,16,440,440,880,32,0,0.0,5.0,15,386,472,858,0.975
1987001,90,16,440,440,880,33,0,0.0,5.818182,15,390,435,825,0.9375
1987001,90,16,440,440,880,33,0,0.0,6.818182,15,379,425,804,0.913636364
1987001,90,16,440,440,880,33,0,0.0,7.818182,16,487,369,856,0.972727273
1987001,90,16,440,440,880,33,0,0.0,8.818182,13,353,374,727,0.826136364
1988001,100,25,650,650,1300,10,0,0.0,0.0,23,31,1233,1264,0.972307692
1988002,100,25,650,650,1300,10,0,0.0,0.0,25,161,1139,1300,1.0
1988003,100,25,650,650,1300,10,0,0.0,0.0,19,-281,1413,1132,0.870769231
1988004,100,25,650,650,1300,10,0,0.0,0.0,21,1286,-62,1224,0.941538462
1988005,100,25,650,650,1300,10,0,0.0,0.0,23,1199,61,1260,0.969230769
1988006,100,25,650,650,1300,10,0,0.0,0.0,25,149,1151,1300,1.0
1989001,72,9,144,315,459,10,0,0.2,1.8,14,252,71,323,0.703703704
1989001,72,9,144,315,459,10,0,0.2,2.8,12,35,347,382,0.832244009
1989002,72,9,144,315,459,10,0,0.2,1.6,12,113,268,381,0.830065359
1989002,72,9,144,315,459,10,0,0.2,2.6,11,-230,547,317,0.690631808
1990001,126,24,300,552,852,20,0,0.1,3.75,22,351,436,787,0.92370892
1990001,126,24,300,552,852,20,0,0.1,4.75,22,286,470,756,0.887323944
1990002,126,24,300,552,852,20,0,0.2,3.45,24,439,324,763,0.895539906
1990002,126,24,300,552,852,20,0,0.2,4.45,21,432,371,803,0.942488263
1990003,126,24,300,552,852,20,0,0.3,3.65,18,382,336,718,0.842723005
1990003,126,24,300,552,852,20,0,0.3,4.65,22,551,251,802,0.941314554
1990004,126,24,300,552,852,20,0,0.3,3.75,22,283,508,791,0.928403756
1990004,126,24,300,552,852,20,0,0.3,4.75,22,313,498,811,0.951877934
1990005,126,24,300,552,852,20,0,0.2,3.7,26,307,509,816,0.957746479
1990005,126,24,300,552,852,20,0,0.2,4.7,21,443,314,757,0.888497653
1990006,126,24,300,552,852,20,0,0.2,3.6,22,189,592,781,0.916666667
1990006,126,24,300,552,852,20,0,0.2,4.6,24,243,583,826,0.969483568
1990007,126,24,300,552,852,20,0,0.1,3.6,23,279,507,786,0.922535211
1990007,126,24,300,552,852,20,0,0.1,4.6,22,280,524,804,0.943661972
1990008,126,24,300,552,852,20,0,0.3,3.6,19,547,177,724,0.849765258
1990008,126,24,300,552,852,20,0,0.3,4.6,20,432,320,752,0.882629108
1990009,126,24,300,552,852,20,0,0.0,3.95,22,243,548,791,0.928403756
1990009,126,24,300,552,852,20,0,0.0,4.95,25,-29,817,788,0.924882629
1990010,126,24,300,552,852,20,0,0.1,3.95,24,430,393,823,0.965962441
1990010,126,24,300,552,852,20,0,0.1,4.95,22,333,403,736,0.863849765
1991001,107,4,100,126,226,10,0,0.0,0.4,4,60,142,202,0.89380531
1991002,107,4,100,126,226,10,0,0.0,0.2,4,7,171,178,0.787610619
1991003,107,4,100,126,226,10,0,0.0,0.6,4,57,135,192,0.849557522
1991004,107,4,100,126,226,10,0,0.0,0.3,4,31,159,190,0.840707965
1991005,107,4,100,126,226,9,0,0.0,0.0,2,42,117,159,0.703539823
1993001,129,30,1095,1500,2595,30,0,0.0,2.9333334,24,1061,1119,2180,0.840077071
1993002,129,30,1095,1500,2595,30,0,0.0,3.0,26,1287,986,2273,0.875915222
1993003,129,30,1095,1500,2595,30,0,0.0,2.9666667,24,1240,887,2127,0.819653179
1993004,129,30,1095,1500,2595,30,0,0.0,2.9333334,25,1327,857,2184,0.841618497
1993005,129,30,1095,1500,2595,30,0,0.0,2.9666667,28,671,1776,2447,0.942967245
1993006,129,30,1095,1500,2595,30,0,0.0,2.9333334,28,835,1603,2438,0.939499037
1993007,124,8,376,448,824,8,0,0.0,2.625,6,-4,619,615,0.746359223
1994001,102,45,1242,1182,2424,32,0,2.65625,5.46875,37,1373,825,2198,0.906765677
1995001,118,9,144,216,360,8,0,0.125,1.875,7,133,163,296,0.822222222
1995002,118,9,144,216,360,8,0,0.5,1.5,10,145,197,342,0.95
1995003,118,9,144,216,360,8,0,0.125,1.875,8,262,98,360,1.0
1995004,118,9,144,216,360,8,0,0.25,1.75,8,119,203,322,0.894444444
1996001,112,13,260,416,676,10,1,1.2,2.8,13,179,497,676,1.0
1997001,100,21,672,672,1344,14,0,8.214286,13.785714,12,416,474,890,0.662202381
1997001,99,21,693,693,1386,15,0,7.9333334,14.333333,14,618,352,970,0.6998557
1997001,99,21,693,693,1386,15,0,7.9333334,15.333333,12,497,444,941,0.678932179
1997001,99,21,693,693,1386,15,0,7.9333334,16.333334,10,235,453,688,0.496392496
1997001,99,21,693,693,1386,15,0,7.9333334,17.333334,14,278,709,987,0.712121212
1997001,99,21,693,693,1386,15,0,7.9333334,18.333334,9,364,270,634,0.457431457
1999001,112,13,260,416,676,10,1,0.0,0.0,15,274,386,660,0.976331361
1999001,112,13,260,416,676,10,1,0.0,1.0,11,311,300,611,0.903846154
1999002,112,13,260,416,676,10,1,0.0,0.0,12,260,380,640,0.946745562
1999002,112,13,260,416,676,10,1,0.0,1.0,12,-37,678,641,0.948224852
2001001,112,13,260,416,676,10,1,1.0,6.2,7,287,185,472,0.698224852
2001002,112,13,260,416,676,10,1,1.0,6.0,9,351,235,586,0.866863905
2001003,112,13,260,416,676,10,1,0.9,6.6,8,276,243,519,0.767751479
2003001,160,15,21600,1125,22725,10,0,0.0,6.9,15,10916,11809,22725,1.0
2003002,160,15,21600,1125,22725,10,0,0.0,6.8,14,9961,12669,22630,0.995819582
2003003,160,15,21600,1125,22725,10,0,0.0,7.0,13,13730,8630,22360,0.983938394
2003004,355,9,13005,2475,15480,6,0,0.0,7.0,9,4469,11011,15480,1.0
2011001,112,13,260,416,676,10,1,0.8,2.2,11,303,336,639,0.945266272
2012001,112,13,260,416,676,10,1,0.0,1.6,3,-32,305,273,0.403846154
2012002,112,13,260,416,676,10,1,0.0,1.5,10,-221,756,535,0.791420118
2012003,112,13,260,416,676,10,1,0.3,1.4,7,-115,518,403,0.596153846
2012004,112,9,180,288,468,6,0,0.16666667,1.5,4,-44,351,307,0.655982906
2013001,112,13,260,416,676,10,1,0.0,1.0,13,53,600,653,0.965976331
2013003,112,13,260,416,676,10,1,0.0,1.3,12,82,529,611,0.903846154
2013004,112,13,260,416,676,10,1,0.0,1.5,7,200,261,461,0.681952663
2013005,101,6,195,201,396,5,0,0.0,1.8,1,48,44,92,0.232323232
2014001,100,51,1275,1275,2550,41,0,0.0,0.9756098,54,1149,1308,2457,0.963529412
2016001,112,9,180,288,468,6,0,1.0,0.0,7,-91,495,404,0.863247863
2017001,107,15,330,435,765,14,0,0.0,0.0,17,247,471,718,0.938562092
2017001,107,15,330,435,765,14,0,0.0,1.0,16,327,409,736,0.962091503
2017002,107,15,330,435,765,14,0,0.0,0.0,12,263,413,676,0.883660131
2017002,107,15,330,435,765,14,0,0.0,1.0,15,300,385,685,0.895424837
2018001,489,16,4304,4260,8564,17,0,0.0,3.6470587,18,-1072,8666,7594,0.88673517
2019001,108,224,4631,6472,11103,175,0,0.0,0.0,138,1950,5218,7168,0.645591282
2021001,662,10,2380,1245,3625,34,0,0.0,12.735294,10,2390,560,2950,0.813793103
2022001,100,21,630,630,1260,15,0,0.0,8.533334,16,406,620,1026,0.814285714
2023001,50,26,650,650,1300,20,0,0.0,5.0,26,462,740,1202,0.924615385
2025002,112,13,260,416,676,10,1,0.2,2.8,12,295,359,654,0.967455621
2025003,112,13,260,416,676,10,1,0.6,2.4,11,463,174,637,0.942307692
2025004,112,13,260,416,676,10,1,0.6,2.4,9,249,291,540,0.798816568
2026001,90,11,275,275,550,8,0,0.75,1.25,14,77,383,460,0.836363636
2028001,83,34,1156,561,1717,35,0,0.0,1.0,34,700,822,1522,0.886429819
2028001,83,34,1156,561,1717,35,0,0.0,2.0,34,924,566,1490,0.867792662
2028001,83,34,1156,561,1717,35,0,0.0,3.0,36,1125,466,1591,0.926616191
2028001,83,34,1156,561,1717,35,0,0.0,4.0,33,1132,495,1627,0.947582994
2029001,112,13,260,416,676,10,1,0.9,0.3,11,346,163,509,0.75295858
2029002,112,13,260,416,676,10,1,0.0,0.6,13,282,355,637,0.942307692
2030001,100,8,204,204,408,10,0,0.7,4.2,11,44,153,197,0.482843137
2031001,65,13,780,390,1170,10,0,0.7,6.4,10,-8,1043,1035,0.884615385
2031001,65,13,780,390,1170,10,0,0.7,7.4,12,462,638,1100,0.94017094
2031002,65,13,780,390,1170,10,0,0.3,5.9,12,212,883,1095,0.935897436
2031002,65,13,780,390,1170,10,0,0.3,6.9,12,485,680,1165,0.995726496
2031003,65,13,780,390,1170,10,0,0.4,6.2,14,-1371,2506,1135,0.97008547
2031003,65,13,780,390,1170,10,0,0.4,7.2,13,-254,1324,1070,0.914529915
2031004,65,13,780,390,1170,10,0,1.9,5.1,14,450,670,1120,0.957264957
2031004,65,13,780,390,1170,10,0,1.9,6.1,12,488,602,1090,0.931623932
2033001,112,13,260,416,676,10,1,0.2,3.7,15,274,386,660,0.976331361
2036001,100,24,648,648,1296,17,0,0.0,0.0,22,595,635,1230,0.949074074
2036001,100,24,648,648,1296,17,0,0.0,1.0,24,647,631,1278,0.986111111
2036001,100,24,648,648,1296,17,0,0.0,2.0,24,809,467,1276,0.984567901
2036001,100,24,648,648,1296,17,0,0.0,3.0,24,790,500,1290,0.99537037
2036001,100,24,648,648,1296,17,0,0.0,4.0,22,46,1200,1246,0.961419753
2037001,96,7,198,169,367,15,0,0.0,3.0,6,156,136,292,0.795640327
2038001,110,13,234,390,624,10,0,0.4,2.6,12,224,334,558,0.894230769
2038002,110,13,234,390,624,10,0,0.0,3.0,11,-170,686,516,0.826923077
2038003,110,13,234,390,624,10,0,0.2,2.8,12,239,337,576,0.923076923
2041001,110,13,234,390,624,10,0,0.7,1.3,12,356,184,540,0.865384615
2041002,110,13,234,390,624,10,0,0.2,1.8,10,72,383,455,0.729166667
2041003,110,13,234,390,624,10,0,0.5,1.6,12,141,448,589,0.943910256
2043001,115,107,1890,3522,5412,75,0,0.0,0.0,99,1793,3297,5090,0.940502587
2044001,81,7,70,112,182,10,0,0.8,3.2,6,5,129,134,0.736263736
2044001,81,7,70,112,182,10,0,0.8,4.2,9,137,-17,120,0.659340659
2044001,81,7,70,112,182,10,0,0.8,5.2,7,-57,217,160,0.879120879
2044001,81,7,70,112,182,10,0,0.8,6.2,10,81,49,130,0.714285714
2044001,81,7,70,112,182,10,0,0.8,7.2,8,88,35,123,0.675824176
2044002,81,7,70,112,182,10,0,0.4,2.7,8,134,-44,90,0.494505495
2044002,81,7,70,112,182,10,0,0.4,3.7,9,34,41,75,0.412087912
2044002,81,7,70,112,182,10,0,0.4,4.7,11,-336,335,-1,-0.005494505
2044002,81,7,70,112,182,10,0,0.4,5.7,7,124,-109,15,0.082417582
2044002,81,7,70,112,182,10,0,0.4,6.7,8,59,63,122,0.67032967
2045001,112,9,180,288,468,6,0,0.0,7.0,8,261,200,461,0.985042735
2047001,550,15,3750,3750,7500,20,0,0.1,2.4,22,1801,1099,2900,0.386666667
2047002,550,15,3750,3750,7500,20,0,0.1,2.5,13,2580,1720,4300,0.573333333
2047003,550,15,3750,3750,7500,20,0,0.0,2.95,11,1819,2681,4500,0.6
2047004,550,15,3750,3750,7500,20,0,0.15,2.15,15,1025,3975,5000,0.666666667
2047005,550,15,3750,3750,7500,20,0,0.05,2.65,20,1933,3267,5200,0.693333333
2047006,550,15,3750,3750,7500,20,0,0.05,2.65,16,-193,4393,4200,0.56
2047007,550,15,3750,3750,7500,20,0,0.05,2.7,20,1662,2438,4100,0.546666667
2047008,550,15,3750,3750,7500,20,0,0.0,2.4,13,3439,1961,5400,0.72
2047009,550,15,3750,3750,7500,11,0,0.09090909,2.090909,10,2197,3903,6100,0.813333333
2050001,4158,23,59866,44595,104461,16,0,2.375,4.6875,23,31846,31397,63243,0.605422119
2050001,4158,25,64850,48449,113299,18,0,2.1111112,5.611111,29,55140,39440,94580,0.834782302
2050001,4158,25,64850,48449,113299,18,0,2.1111112,6.611111,28,66050,19862,85912,0.758276772
2051001,102,45,1242,1182,2424,32,0,2.65625,6.46875,39,968,1310,2278,0.939768977
2055001,101,27,891,918,1809,18,0,3.0,0.0,20,-201,1644,1443,0.797678275
2055001,100,27,918,927,1845,19,0,3.0,0.94736844,24,-230,1882,1652,0.895392954
2059001,110,21,420,630,1050,16,0,0.0,2.875,4,186,138,324,0.308571429
2059002,110,19,384,576,960,14,0,0.0,3.0,2,30,155,185,0.192708333
2061001,100,21,672,672,1344,14,0,0.0,0.5,17,953,237,1190,0.885416667
2061001,100,21,672,672,1344,14,0,0.0,1.5,16,411,736,1147,0.853422619
2061001,100,21,672,672,1344,14,0,0.0,2.5,16,600,502,1102,0.819940476
2061001,100,21,672,672,1344,14,0,0.0,3.5,18,689,495,1184,0.880952381
2062001,103,25,725,725,1450,10,0,0.0,0.6,23,688,710,1398,0.964137931
2062001,103,25,725,725,1450,10,0,0.0,1.6,22,709,643,1352,0.932413793
2062001,103,25,725,725,1450,10,0,0.0,2.6,22,542,804,1346,0.928275862
2062002,98,15,540,468,1008,7,0,0.42857143,0.0,15,171,805,976,0.968253968
2062002,98,15,540,468,1008,7,0,0.42857143,1.0,15,611,371,982,0.974206349
2062002,98,15,540,468,1008,7,0,0.42857143,2.0,15,495,485,980,0.972222222
2063001,482,19,5054,4712,9766,25,0,0.0,4.0,19,3032,5114,8146,0.83411837
2063002,495,18,4610,4568,9178,22,0,0.0,3.8636363,14,2030,6064,8094,0.88189148
2064001,110,21,420,630,1050,15,0,0.0,2.0,21,378,648,1026,0.977142857
2065001,118,9,144,216,360,8,0,0.125,1.875,5,46,176,222,0.616666667
2065002,118,9,144,216,360,8,0,0.5,1.5,11,86,232,318,0.883333333
2065003,118,9,144,216,360,8,0,0.125,1.875,9,55,297,352,0.977777778
2067001,112,13,260,416,676,10,1,0.9,5.9,14,221,441,662,0.979289941
2067002,112,13,260,416,676,10,1,0.7,5.8,12,418,233,651,0.963017751
2067003,112,13,260,416,676,10,1,0.6,5.7,9,233,286,519,0.767751479
2068001,110,15,300,450,750,10,0,6.4,2.9,10,62,590,652,0.869333333
2068001,110,15,300,450,750,10,0,6.4,3.9,10,99,508,607,0.809333333
2069001,99,24,780,774,1554,17,0,11.882353,6.470588,15,216,796,1012,0.651222651
2069001,100,27,837,837,1674,18,0,11.611111,7.388889,19,420,850,1270,0.758661888
2069001,100,27,837,837,1674,18,0,11.611111,8.388889,16,-125,1220,1095,0.654121864
2069001,100,27,837,837,1674,18,0,11.611111,9.388889,17,157,954,1111,0.663679809
2069001,100,27,837,837,1674,18,0,11.611111,10.388889,15,185,783,968,0.578255675
2071001,111,38,923,1241,2164,27,0,0.0,0.0,27,976,756,1732,0.800369686
2071001,111,38,923,1241,2164,27,0,0.0,1.0,33,1143,791,1934,0.893715342
2071001,111,38,923,1241,2164,27,0,0.0,2.0,34,1603,440,2043,0.944085028
2073001,112,13,260,416,676,10,1,0.2,2.7,11,401,259,660,0.976331361
2073002,112,13,260,416,676,10,1,0.1,2.9,11,273,322,595,0.880177515
2073003,112,13,260,416,676,10,1,0.1,2.9,13,254,403,657,0.971893491
2073004,112,13,260,416,676,10,1,0.1,2.9,13,482,186,668,0.98816568
2073005,112,13,260,416,676,10,1,0.2,2.7,10,237,319,556,0.822485207
2073006,112,13,260,416,676,10,1,0.1,2.8,11,394,207,601,0.889053254
2073007,112,13,260,416,676,10,1,0.0,3.0,12,260,372,632,0.934911243
2073008,112,13,260,416,676,10,1,0.1,2.9,10,372,214,586,0.866863905
2073009,112,13,260,416,676,10,1,0.0,3.0,14,344,315,659,0.974852071
2073010,112,13,260,416,676,10,1,0.1,2.9,10,299,320,619,0.915680473
2073011,112,13,260,416,676,10,1,0.1,2.9,11,237,387,624,0.923076923
2073012,112,13,260,416,676,10,1,0.2,2.8,12,408,254,662,0.979289941
2073013,112,13,260,416,676,10,1,0.1,2.9,10,99,389,488,0.721893491
2073014,112,13,260,416,676,10,1,0.2,2.8,12,406,254,660,0.976331361
2073015,112,13,260,416,676,10,1,0.2,2.8,13,148,484,632,0.934911243
2074001,112,13,260,416,676,10,1,0.5,3.5,11,334,206,540,0.798816568
2074002,112,13,260,416,676,10,1,0.6,3.4,7,-201,662,461,0.681952663
2074003,112,13,260,416,676,10,1,0.7,3.3,14,263,397,660,0.976331361
2074004,112,13,260,416,676,10,1,0.9,3.1,15,266,394,660,0.976331361
2075001,100,50,1275,1275,2550,10,0,0.0,4.3,41,294,1922,2216,0.869019608
2075002,92,20,700,536,1236,5,0,0.0,4.8,18,478,562,1040,0.841423948
2076001,131,7,161,112,273,10,0,0.6,7.5,4,122,35,157,0.575091575
2076001,131,7,161,112,273,10,0,0.6,8.5,6,209,44,253,0.926739927
2076002,131,7,161,112,273,10,0,1.1,7.6,7,243,3,246,0.901098901
2076002,131,7,161,112,273,10,0,1.1,8.6,5,157,59,216,0.791208791
2076003,131,7,161,112,273,10,0,0.9,8.1,6,145,98,243,0.89010989
2076003,131,7,161,112,273,10,0,0.9,9.1,5,112,67,179,0.655677656
2078001,110,21,420,630,1050,16,0,0.0,1.0,21,613,394,1007,0.959047619
2078002,110,21,420,630,1050,16,0,0.0,1.0,19,243,682,925,0.880952381
2082001,103,48,1281,1281,2562,34,0,0.0,3.0294118,50,2015,540,2555,0.99726776
2084001,112,13,260,416,676,10,1,0.0,2.7,11,214,423,637,0.942307692
2084001,112,13,260,416,676,10,1,0.0,3.7,12,229,433,662,0.979289941
2084002,112,13,260,416,676,10,1,4.0,7.6,12,414,226,640,0.946745562
2084002,112,13,260,416,676,10,1,4.0,8.6,13,154,507,661,0.977810651
2084003,112,13,260,416,676,10,1,0.0,3.0,13,392,258,650,0.961538462
2084003,112,13,260,416,676,10,1,0.0,4.0,13,448,207,655,0.968934911
2085001,112,13,260,416,676,10,1,0.0,4.0,13,72,562,634,0.937869822
2085002,112,13,260,416,676,10,1,0.2,3.8,12,165,482,647,0.957100592
2085003,112,13,260,416,676,10,1,0.0,4.0,11,-284,849,565,0.835798817
2085004,112,13,260,416,676,10,1,0.4,3.6,9,-15,570,555,0.821005917
2086001,92,15,210,315,525,16,0,3.25,0.625,16,187,298,485,0.923809524
2087001,112,13,260,416,676,10,1,0.2,8.4,14,342,327,669,0.98964497
2087002,112,13,260,416,676,10,1,0.0,9.0,12,260,384,644,0.952662722
2087003,112,13,260,416,676,10,1,0.2,9.0,13,259,396,655,0.968934911
2087004,112,13,260,416,676,10,1,0.7,8.7,11,426,198,624,0.923076923
2088001,81,12,432,498,930,10,0,2.1,11.6,14,365,524,889,0.955913978
2088001,81,12,432,498,930,10,0,2.1,12.6,10,269,518,787,0.846236559
2088001,81,12,432,498,930,10,0,2.1,13.6,10,385,390,775,0.833333333
2088002,81,12,432,498,930,10,0,3.3,8.3,11,195,656,851,0.915053763
2088002,81,12,432,498,930,10,0,3.3,9.3,9,307,488,795,0.85483871
2088002,81,12,432,498,930,10,0,3.3,10.3,11,356,519,875,0.940860215
2088003,81,6,216,249,465,4,0,1.5,10.0,5,118,341,459,0.987096774
2089001,112,13,260,416,676,10,1,0.0,2.5,10,126,415,541,0.800295858
2089002,112,13,260,416,676,10,1,0.0,3.0,14,254,413,667,0.986686391
2089003,112,13,260,416,676,10,1,0.3,2.4,13,230,437,667,0.986686391
2090001,112,13,260,416,676,10,1,0.1,0.9,8,-417,916,499,0.73816568
2090002,112,13,260,416,676,10,1,0.1,1.1,10,148,448,596,0.881656805
2090003,112,13,260,416,676,10,1,0.0,0.9,5,142,196,338,0.5
2090004,112,13,260,416,676,10,1,0.1,0.8,8,324,172,496,0.733727811
2090005,112,13,260,416,676,10,1,0.0,0.9,5,41,361,402,0.594674556
2091001,96,7,210,266,476,10,0,0.2,7.4,4,-53,281,228,0.478991597
2091001,96,7,210,266,476,10,0,0.2,8.4,5,103,316,419,0.880252101
2091002,96,7,210,266,476,10,0,0.8,7.2,6,186,231,417,0.87605042
2091002,96,7,210,266,476,10,0,0.8,8.2,3,27,169,196,0.411764706
2091003,96,7,210,266,476,10,0,0.0,7.4,8,175,252,427,0.897058824
2091003,96,7,210,266,476,10,0,0.0,8.4,10,94,301,395,0.829831933
2091004,96,7,210,266,476,10,0,0.3,7.2,6,78,279,357,0.75
2091004,96,7,210,266,476,10,0,0.3,8.2,4,84,190,274,0.575630252
2091005,96,7,210,266,476,10,0,0.0,8.0,6,188,192,380,0.798319328
2091005,96,7,210,266,476,10,0,0.0,9.0,7,192,171,363,0.762605042
2091006,96,7,210,266,476,10,0,0.7,7.3,8,31,410,441,0.926470588
2091006,96,7,210,266,476,10,0,0.7,8.3,6,25,293,318,0.668067227
2091007,96,7,210,266,476,10,0,0.0,8.0,4,111,237,348,0.731092437
2091007,96,7,210,266,476,10,0,0.0,9.0,5,-133,503,370,0.777310924
2091008,96,7,210,266,476,10,0,0.2,7.8,7,225,165,390,0.819327731
2091008,96,7,210,266,476,10,0,0.2,8.8,4,0,223,223,0.468487395
2091009,96,7,210,266,476,10,0,0.1,7.8,3,37,211,248,0.521008403
2091009,96,7,210,266,476,10,0,0.1,8.8,5,160,232,392,0.823529412
2091010,96,7,210,266,476,10,0,0.2,6.6,7,-94,505,411,0.863445378
2091010,96,7,210,266,476,10,0,0.2,7.6,8,124,208,332,0.697478992
2091011,96,7,210,266,476,10,0,0.1,7.9,4,17,189,206,0.432773109
2091011,96,7,210,266,476,10,0,0.1,8.9,6,-86,419,333,0.699579832
2091012,96,7,210,266,476,10,0,0.2,7.3,8,107,302,409,0.859243697
2091012,96,7,210,266,476,10,0,0.2,8.3,5,226,81,307,0.644957983
2091013,96,7,210,266,476,10,0,0.7,7.2,6,-257,581,324,0.680672269
2091013,96,7,210,266,476,10,0,0.7,8.2,6,207,210,417,0.87605042
2091014,96,7,210,266,476,10,0,0.0,8.0,9,-202,600,398,0.836134454
2091014,96,7,210,266,476,10,0,0.0,9.0,8,-146,540,394,0.827731092
2091015,96,7,210,266,476,10,0,0.1,7.9,3,53,233,286,0.600840336
2091015,96,7,210,266,476,10,0,0.1,8.9,4,67,248,315,0.661764706
2091016,96,7,210,266,476,10,0,0.2,7.3,7,188,234,422,0.886554622
2091016,96,7,210,266,476,10,0,0.2,8.3,6,213,106,319,0.670168067
2091017,96,7,210,266,476,10,0,0.0,8.0,8,71,316,387,0.81302521
2091017,96,7,210,266,476,10,0,0.0,9.0,8,109,321,430,0.903361345
2091018,96,7,210,266,476,10,0,0.8,7.2,8,173,279,452,0.949579832
2091018,96,7,210,266,476,10,0,0.8,8.2,3,85,167,252,0.529411765
2091019,96,7,210,266,476,10,0,0.9,7.1,6,38,362,400,0.840336134
2091019,96,7,210,266,476,10,0,0.9,8.1,4,49,261,310,0.651260504
2091020,96,7,210,266,476,10,0,0.2,7.8,6,100,297,397,0.834033613
2091020,96,7,210,266,476,10,0,0.2,8.8,7,-156,552,396,0.831932773
2091021,96,7,210,266,476,10,0,0.3,7.2,5,117,225,342,0.718487395
2091021,96,7,210,266,476,10,0,0.3,8.2,3,21,241,262,0.550420168
2091022,96,7,210,266,476,10,0,0.4,6.3,7,158,277,435,0.913865546
2091022,96,7,210,266,476,10,0,0.4,7.3,5,78,258,336,0.705882353
2091023,96,7,210,266,476,10,0,0.7,7.3,6,-8,395,387,0.81302521
2091023,96,7,210,266,476,10,0,0.7,8.3,7,175,177,352,0.739495798
2091024,96,4,120,152,272,4,0,0.0,6.25,3,156,97,253,0.930147059
2092001,110,21,420,630,1050,16,0,0.0,2.875,20,196,785,981,0.934285714
2092001,110,21,420,630,1050,16,0,0.0,3.875,19,272,712,984,0.937142857
2092002,110,21,420,630,1050,16,0,0.0,2.9375,21,289,698,987,0.94
2092002,110,21,420,630,1050,16,0,0.0,3.9375,17,144,718,862,0.820952381
2092003,110,21,420,630,1050,16,0,0.0,3.0,18,456,511,967,0.920952381
2092003,110,21,420,630,1050,16,0,0.0,4.0,21,620,376,996,0.948571429
2092004,110,21,420,630,1050,16,0,0.0,3.0,21,605,395,1000,0.952380952
2092004,110,21,420,630,1050,16,0,0.0,4.0,22,402,603,1005,0.957142857
2092005,110,21,420,630,1050,16,0,0.0,2.75,19,379,587,966,0.92
2092005,110,21,420,630,1050,16,0,0.0,3.75,19,302,624,926,0.881904762
2092006,110,21,420,630,1050,16,0,0.0,3.0,16,471,404,875,0.833333333
2092006,110,21,420,630,1050,16,0,0.0,4.0,23,604,429,1033,0.983809524
2092007,110,21,420,630,1050,16,0,0.0,2.9375,19,482,487,969,0.922857143
2092007,110,21,420,630,1050,16,0,0.0,3.9375,22,479,507,986,0.939047619
2092008,110,21,420,630,1050,16,0,0.0,2.9375,17,268,650,918,0.874285714
2092008,110,21,420,630,1050,16,0,0.0,3.9375,18,341,543,884,0.841904762
2092009,110,21,420,630,1050,16,0,0.0,2.875,19,463,459,922,0.878095238
2092009,110,21,420,630,1050,16,0,0.0,3.875,21,483,480,963,0.917142857
2092010,110,21,420,630,1050,16,0,0.0,2.875,17,415,505,920,0.876190476
2092010,110,21,420,630,1050,16,0,0.0,3.875,18,287,583,870,0.828571429
2092011,110,21,420,630,1050,16,0,0.0,3.0,19,438,513,951,0.905714286
2092011,110,21,420,630,1050,16,0,0.0,4.0,22,140,860,1000,0.952380952
2092012,110,21,420,630,1050,16,0,0.0,2.6875,17,136,650,786,0.748571429
2092012,110,21,420,630,1050,16,0,0.0,3.6875,22,115,875,990,0.942857143
2092013,110,21,420,630,1050,16,0,0.0,2.9375,20,-252,1180,928,0.883809524
2092013,110,21,420,630,1050,16,0,0.0,3.9375,21,-101,1089,988,0.940952381
2092014,110,21,420,630,1050,16,0,0.0,2.9375,14,450,245,695,0.661904762
2092014,110,21,420,630,1050,16,0,0.0,3.9375,22,306,646,952,0.906666667
2092015,110,21,420,630,1050,16,0,0.0,2.9375,15,488,231,719,0.684761905
2092015,110,21,420,630,1050,16,0,0.0,3.9375,13,387,352,739,0.703809524
2092016,110,21,420,630,1050,16,0,0.0,2.875,18,465,488,953,0.907619048
2093001,112,13,260,416,676,10,1,0.0,0.9,8,121,442,563,0.832840237
2093002,112,13,260,416,676,10,1,0.0,1.0,9,130,428,558,0.825443787
2093003,112,13,260,416,676,10,1,0.0,0.9,6,247,153,400,0.591715976
2093004,112,13,260,416,676,10,1,0.0,1.0,7,108,319,427,0.631656805
2093005,112,13,260,416,676,10,1,0.0,0.9,7,168,287,455,0.673076923
2094001,110,21,420,630,1050,16,0,0.0,3.9375,13,357,503,860,0.819047619
2094001,110,21,420,630,1050,16,0,0.0,4.9375,14,620,252,872,0.83047619
2094002,110,21,420,630,1050,16,0,0.0,3.9375,13,507,336,843,0.802857143
2094002,110,21,420,630,1050,16,0,0.0,4.9375,16,594,368,962,0.916190476
2094003,110,21,420,630,1050,16,0,0.0,4.0625,13,461,339,800,0.761904762
2094003,110,21,420,630,1050,16,0,0.0,5.0625,16,521,368,889,0.846666667
2094004,110,21,420,630,1050,16,0,0.0625,4.25,14,705,164,869,0.827619048
2094004,110,21,420,630,1050,16,0,0.0625,5.25,12,534,137,671,0.639047619
2094005,110,21,420,630,1050,16,0,0.0,4.1875,13,-55,900,845,0.804761905
2094005,110,21,420,630,1050,16,0,0.0,5.1875,18,542,444,986,0.939047619
2094006,110,21,420,630,1050,16,0,0.0,4.25,16,431,451,882,0.84
2094006,110,21,420,630,1050,16,0,0.0,5.25,17,568,367,935,0.89047619
2094007,110,21,420,630,1050,16,0,0.0,4.4375,16,495,444,939,0.894285714
2094007,110,21,420,630,1050,16,0,0.0,5.4375,15,663,181,844,0.803809524
2094008,110,21,420,630,1050,16,0,0.0,4.375,15,698,232,930,0.885714286
2094008,110,21,420,630,1050,16,0,0.0,5.375,14,498,404,902,0.859047619
2094009,110,21,420,630,1050,16,0,0.0,4.25,15,498,404,902,0.859047619
2094009,110,21,420,630,1050,16,0,0.0,5.25,15,646,212,858,0.817142857
2094010,98,6,210,198,408,5,0,0.0,4.4,4,277,30,307,0.75245098
2094010,98,6,210,198,408,5,0,0.0,5.4,6,427,-46,381,0.933823529
2096001,112,13,260,416,676,10,1,0.0,9.5,13,635,17,652,0.964497041
2096002,112,13,260,416,676,10,1,0.0,8.6,10,408,191,599,0.886094675
2096003,112,13,260,416,676,10,1,0.0,9.8,7,384,107,491,0.726331361
2097001,114,30,645,1050,1695,20,0,0.0,4.0,16,23,1093,1116,0.65840708
2099001,113,27,648,999,1647,18,0,1.0,2.0,19,163,1111,1274,0.773527626
2100001,112,13,260,416,676,10,1,0.0,0.9,11,55,453,508,0.75147929
2100002,112,13,260,416,676,10,1,0.0,0.9,10,136,408,544,0.804733728
2100003,112,9,180,288,468,6,0,0.0,1.0,6,102,294,396,0.846153846
2101001,65,13,780,390,1170,10,0,0.4,3.8,7,331,569,900,0.769230769
2101001,65,13,780,390,1170,10,0,0.4,4.8,3,191,244,435,0.371794872
2101002,65,13,780,390,1170,10,0,0.9,3.0,12,105,950,1055,0.901709402
2101002,65,13,780,390,1170,10,0,0.9,4.0,3,47,338,385,0.329059829
2101003,65,13,780,390,1170,10,0,1.0,3.6,9,23,892,915,0.782051282
2101003,65,13,780,390,1170,10,0,1.0,4.6,3,224,156,380,0.324786325
2108001,470,104,25517,19604,45121,103,0,0.0,0.0,132,23934,11805,35739,0.792070211
2112001,72,9,144,315,459,10,0,0.8,1.2,12,7,350,357,0.777777778
2112001,72,9,144,315,459,10,0,0.8,2.2,9,-116,335,219,0.477124183
2113001,90,9,117,180,297,10,0,0.3,3.4,8,45,157,202,0.68013468
2113002,90,9,117,180,297,10,0,0.6,3.4,10,57,182,239,0.804713805
2113003,90,9,117,180,297,10,0,0.7,3.3,8,67,164,231,0.777777778
2113004,90,9,117,180,297,10,0,0.6,3.1,12,-323,551,228,0.767676768
2114001,180,11,220,330,550,12,0,0.0,1.0,10,693,-179,514,0.934545455
2114001,180,11,220,330,550,12,0,0.0,2.0,12,189,351,540,0.981818182
2114001,180,11,220,330,550,12,0,0.0,3.0,10,540,-4,536,0.974545455
2114002,180,11,220,330,550,12,0,0.083333336,0.9166667,11,160,374,534,0.970909091
2114002,180,11,220,330,550,12,0,0.083333336,1.9166666,9,336,152,488,0.887272727
2114002,180,11,220,330,550,12,0,0.083333336,2.9166667,11,145,379,524,0.952727273
2114003,180,11,220,330,550,12,0,0.16666667,0.8333333,12,298,242,540,0.981818182
2114003,180,11,220,330,550,12,0,0.16666667,1.8333334,11,186,360,546,0.992727273
2114003,180,11,220,330,550,12,0,0.16666667,2.8333333,10,317,139,456,0.829090909
2114004,180,11,220,330,550,12,0,0.083333336,0.9166667,7,72,394,466,0.847272727
2114004,180,11,220,330,550,12,0,0.083333336,1.9166666,10,212,284,496,0.901818182
2114004,180,11,220,330,550,12,0,0.083333336,2.9166667,10,-838,1334,496,0.901818182
2115001,112,13,260,416,676,10,1,0.0,3.5,11,255,385,640,0.946745562
2116001,112,13,260,416,676,10,1,0.0,0.0,14,222,430,652,0.964497041
2116002,112,13,260,416,676,10,1,0.0,0.0,8,315,131,446,0.659763314
2116003,112,13,260,416,676,10,1,0.0,0.0,12,295,344,639,0.945266272
2117001,103,54,1395,1431,2826,39,0,0.0,0.0,52,588,2114,2702,0.956121727
2118001,152,36,2680,2760,5440,40,0,0.0,1.875,44,3553,847,4400,0.808823529
2120001,112,13,260,416,676,10,1,0.0,0.0,14,245,422,667,0.986686391
2120001,112,13,260,416,676,10,1,0.0,1.0,14,320,349,669,0.98964497
2120001,112,13,260,416,676,10,1,0.0,2.0,13,261,392,653,0.965976331
2120002,112,13,260,416,676,10,1,0.0,0.0,14,92,564,656,0.970414201
2120002,112,13,260,416,676,10,1,0.0,1.0,13,289,341,630,0.931952663
2120002,112,13,260,416,676,10,1,0.0,2.0,14,422,241,663,0.980769231
2120003,112,13,260,416,676,10,1,0.0,0.1,12,400,209,609,0.900887574
2120003,112,13,260,416,676,10,1,0.0,1.1,12,756,-127,629,0.930473373
2120003,112,13,260,416,676,10,1,0.0,2.1,12,600,26,626,0.926035503
2120004,107,9,225,303,528,7,0,0.0,0.0,9,425,58,483,0.914772727
2120004,112,11,223,357,580,8,0,0.0,0.875,9,261,254,515,0.887931034
2120004,112,11,223,357,580,8,0,0.0,1.875,8,308,196,504,0.868965517
2121001,112,13,260,416,676,10,1,0.4,1.6,12,410,229,639,0.945266272
2121001,112,13,260,416,676,10,1,0.4,2.6,14,146,507,653,0.965976331
2121002,112,13,260,416,676,10,1,0.4,1.6,10,176,374,550,0.813609467
2121002,112,13,260,416,676,10,1,0.4,2.6,12,192,470,662,0.979289941
2123001,111,120,2340,3828,6168,92,0,0.0,3.2826087,107,713,4549,5262,0.85311284
2125001,107,89,1935,3012,4947,10,0,0.0,1.0,61,3104,877,3981,0.804730139
2126001,96,10,155,235,390,10,0,2.7,9.6,11,211,133,344,0.882051282
2126001,96,10,155,235,390,10,0,2.7,10.6,11,75,299,374,0.958974359
2126002,96,10,155,235,390,10,0,0.0,4.7,12,139,205,344,0.882051282
2126002,96,10,155,235,390,10,0,0.0,5.7,12,264,70,334,0.856410256
2127001,97,7,203,182,385,14,0,0.0,9.714286,5,118,164,282,0.732467532
2128001,116,17,306,578,884,12,0,0.083333336,2.0,17,198,672,870,0.984162896
2128001,116,17,306,578,884,12,0,0.083333336,3.0,16,419,431,850,0.961538462
2131001,102,45,1242,1182,2424,32,0,0.0,0.0,37,503,1576,2079,0.857673267
2131001,102,45,1242,1182,2424,32,0,0.0,1.0,38,709,1367,2076,0.856435644
2131001,102,45,1242,1182,2424,32,0,0.0,2.0,38,1126,941,2067,0.852722772
2132001,130,116,6985,6985,13970,42,0,0.0,11.452381,106,6063,3548,9611,0.68797423
2133001,131,2,26,17,43,10,0,0.0,4.2,4,24,-6,18,0.418604651
2133002,131,2,26,17,43,10,0,0.0,5.1,4,-61,52,-9,-0.209302326
2133003,131,2,26,17,43,10,0,0.0,3.6,3,-95,88,-7,-0.162790698
2133004,131,2,26,17,43,10,0,0.0,3.7,2,45,-36,9,0.209302326
2133005,131,2,26,17,43,7,0,0.0,3.7142856,2,45,-2,43,1.0
2134001,112,13,260,416,676,10,1,0.0,0.0,15,404,256,660,0.976331361
2135001,90,41,951,820,1771,19,0,0.0,6.894737,39,651,985,1636,0.92377188
2136001,112,13,260,416,676,10,1,0.0,7.9,10,232,376,608,0.899408284
2136002,112,13,260,416,676,10,1,0.0,8.0,11,276,369,645,0.954142012
2136003,112,13,260,416,676,10,1,0.0,7.8,9,253,303,556,0.822485207
2136004,112,9,180,288,468,6,0,0.0,8.0,7,229,211,440,0.94017094
2137001,111,12,336,468,804,25,0,0.0,2.0,12,334,450,784,0.975124378
2138001,98,45,1260,1170,2430,19,0,0.0,7.894737,31,717,1198,1915,0.788065844
2139001,100,11,110,275,385,10,0,0.0,1.0,6,134,125,259,0.672727273
2139001,100,11,110,275,385,10,0,0.0,2.0,12,68,285,353,0.916883117
2139001,100,11,110,275,385,10,0,0.0,3.0,13,72,284,356,0.924675325
2139002,100,11,110,275,385,10,0,0.0,1.0,2,16,105,121,0.314285714
2139002,100,11,110,275,385,10,0,0.0,2.0,10,161,224,385,1.0
2139002,100,11,110,275,385,10,0,0.0,3.0,10,148,227,375,0.974025974
2139003,100,11,110,275,385,10,0,0.2,0.8,8,98,197,295,0.766233766
2139003,100,11,110,275,385,10,0,0.2,1.8,11,141,216,357,0.927272727
2139003,100,11,110,275,385,10,0,0.2,2.8,13,147,212,359,0.932467532
2139004,100,11,110,275,385,10,0,0.3,0.7,7,157,74,231,0.6
2139004,100,11,110,275,385,10,0,0.3,1.7,9,114,223,337,0.875324675
2139004,100,11,110,275,385,10,0,0.3,2.7,10,175,206,381,0.98961039
2143001,100,8,204,204,408,10,0,1.2,4.6,14,-14,126,112,0.274509804
2146001,776,5,200,80,280,10,0,0.0,3.0,7,-81,112,31,0.110714286
2146002,776,5,200,80,280,10,0,0.0,3.0,7,166,38,204,0.728571429
2146003,776,5,200,80,280,10,0,0.0,3.0,7,522,-399,123,0.439285714
2146004,776,5,200,80,280,10,0,0.0,3.0,11,-207,-88,-295,-1.053571429
2146005,776,5,200,80,280,10,0,0.0,2.8,4,-31,53,22,0.078571429
2146006,776,5,200,80,280,10,0,0.0,2.8,7,328,-300,28,0.1
2146007,776,5,200,80,280,10,0,0.0,2.9,8,198,-98,100,0.357142857
2146008,776,5,200,80,280,10,0,0.0,3.0,8,-175,227,52,0.185714286
2146009,776,5,200,80,280,10,0,0.0,3.0,9,-375,268,-107,-0.382142857
2146010,776,5,200,80,280,10,0,0.0,3.0,9,-354,374,20,0.071428571
2146011,776,5,200,80,280,10,0,0.0,3.0,10,493,-581,-88,-0.314285714
2146012,776,5,200,80,280,10,0,0.0,3.0,5,31,78,109,0.389285714
2146013,782,4,170,98,268,8,0,0.0,3.0,8,-1008,904,-104,-0.388059701
2148001,112,13,260,416,676,10,1,0.7,5.9,10,25,554,579,0.856508876
2148002,112,13,260,416,676,10,1,1.1,7.3,12,156,463,619,0.915680473
2148003,112,13,260,416,676,10,1,1.1,6.1,13,-47,663,616,0.911242604
2148004,107,9,225,303,528,7,0,2.7142856,3.142857,9,260,263,523,0.990530303
2149001,95,10,135,225,360,10,0,0.3,1.9,9,100,203,303,0.841666667
2149001,95,10,135,225,360,10,0,0.3,2.9,8,57,263,320,0.888888889
2149002,95,10,135,225,360,10,0,0.0,2.0,11,358,-36,322,0.894444444
2149002,95,10,135,225,360,10,0,0.0,3.0,8,104,196,300,0.833333333
2149003,95,10,135,225,360,10,0,0.0,3.0,9,153,157,310,0.861111111
2149003,95,10,135,225,360,10,0,0.0,4.0,9,106,227,333,0.925
2149004,95,10,135,225,360,10,0,0.3,1.7,11,246,12,258,0.716666667
2149004,95,10,135,225,360,10,0,0.3,2.7,9,329,-51,278,0.772222222
2149005,95,10,135,225,360,10,0,0.3,1.6,9,120,189,309,0.858333333
2149005,95,10,135,225,360,10,0,0.3,2.6,9,91,219,310,0.861111111
2151001,90,64,2449,2449,4898,74,0,0.0,3.0,86,1283,2002,3285,0.670681911
2152001,112,13,260,416,676,10,1,0.0,0.0,12,42,589,631,0.933431953
2152002,112,13,260,416,676,10,1,0.0,0.0,14,214,458,672,0.99408284
2152003,112,13,260,416,676,10,1,0.0,0.0,14,482,177,659,0.974852071
2152004,112,13,260,416,676,10,1,0.0,0.0,13,590,52,642,0.949704142
2152005,112,13,260,416,676,10,1,0.0,0.0,14,-157,800,643,0.951183432
2152006,112,13,260,416,676,10,1,0.0,0.0,14,148,521,669,0.98964497
2152007,112,13,260,416,676,10,1,0.0,0.0,15,-204,864,660,0.976331361
2152008,112,13,260,416,676,10,1,0.1,0.3,14,215,440,655,0.968934911
2152009,107,9,225,303,528,7,0,0.0,0.0,8,434,-10,424,0.803030303
2153001,124,15,375,585,960,10,0,0.0,1.0,14,397,550,947,0.986458333
2153002,124,15,375,585,960,10,0,0.0,1.0,13,308,548,856,0.891666667
2153003,124,15,375,585,960,10,0,0.0,1.0,12,227,625,852,0.8875
2153004,124,15,375,585,960,10,0,0.0,1.0,13,317,601,918,0.95625
2153005,124,15,375,585,960,10,0,0.0,1.0,13,170,766,936,0.975
2153006,124,15,375,585,960,10,0,0.0,1.0,14,435,502,937,0.976041667
2153007,111,6,255,261,516,5,0,0.0,1.0,5,292,107,399,0.773255814
2155001,122,13,260,416,676,10,0,0.0,3.0,9,258,237,495,0.732248521
2155002,122,13,260,416,676,10,0,0.0,2.9,12,-395,1006,611,0.903846154
2155003,122,13,260,416,676,10,0,0.3,2.7,12,250,394,644,0.952662722
2155004,122,13,260,416,676,10,0,0.0,3.3,13,463,199,662,0.979289941
2155005,122,13,260,416,676,10,0,0.0,3.0,11,-90,623,533,0.788461538
2155006,122,13,260,416,676,10,0,0.0,3.0,12,286,334,620,0.917159763
2155007,122,13,260,416,676,10,0,0.0,3.0,11,501,147,648,0.958579882
2155008,122,13,260,416,676,10,0,0.0,3.0,12,359,289,648,0.958579882
2155009,122,13,260,416,676,10,0,0.0,3.0,9,160,368,528,0.781065089
2155010,122,13,260,416,676,10,0,0.0,3.0,14,497,175,672,0.99408284
2155011,122,13,260,416,676,10,0,0.0,3.0,15,274,386,660,0.976331361
2155012,122,13,260,416,676,10,0,0.0,3.0,10,10,484,494,0.730769231
2155013,122,13,260,416,676,10,0,0.0,3.0,11,349,225,574,0.849112426
2155014,122,13,260,416,676,10,0,0.0,3.0,13,370,303,673,0.99556213
2155015,122,13,260,416,676,10,0,0.0,3.0,13,336,308,644,0.952662722
2155016,122,13,260,416,676,10,0,0.0,2.9,13,276,358,634,0.937869822
2155017,122,13,260,416,676,10,0,0.3,2.6,11,340,308,648,0.958579882
2155018,122,13,260,416,676,10,0,0.3,2.7,11,509,41,550,0.813609467
2155019,122,13,260,416,676,10,0,0.0,3.0,12,199,413,612,0.905325444
2155020,122,13,260,416,676,10,0,0.0,3.5,11,138,399,537,0.794378698
2155021,122,13,260,416,676,10,0,0.0,3.0,10,353,253,606,0.896449704
2155022,122,13,260,416,676,10,0,0.0,3.0,14,375,294,669,0.98964497
2155023,122,13,260,416,676,10,0,0.0,3.0,14,423,244,667,0.986686391
2155024,122,13,260,416,676,10,0,0.3,2.7,13,174,485,659,0.974852071
2155025,122,13,260,416,676,10,0,0.0,3.2,13,151,499,650,0.961538462
2155026,118,12,270,366,636,9,0,0.0,2.6666667,11,455,151,606,0.952830189
2156001,96,7,210,266,476,10,0,0.4,3.6,6,208,224,432,0.907563025
2156002,96,7,210,266,476,10,0,0.0,4.0,6,206,235,441,0.926470588
2156003,96,7,210,266,476,10,0,0.0,4.0,8,49,378,427,0.897058824
2156004,96,7,210,266,476,10,0,0.0,4.0,7,124,286,410,0.861344538
2156005,96,7,210,266,476,10,0,0.4,3.6,4,132,199,331,0.695378151
2156006,96,7,210,266,476,10,0,0.0,4.0,8,128,198,326,0.68487395
2156007,96,7,210,266,476,10,0,0.0,4.0,6,66,287,353,0.741596639
2156008,96,7,210,266,476,10,0,0.0,4.0,5,176,171,347,0.728991597
2156009,96,7,210,266,476,10,0,0.0,4.0,6,241,128,369,0.775210084
2156010,96,7,210,266,476,10,0,0.4,3.6,4,130,183,313,0.657563025
2156011,96,7,210,266,476,10,0,0.0,4.0,5,84,272,356,0.74789916
2156012,96,7,210,266,476,10,0,0.4,3.6,5,173,229,402,0.844537815
2156013,96,7,210,266,476,10,0,0.0,3.6,7,117,299,416,0.87394958
2156014,96,7,210,266,476,10,0,0.4,3.6,8,176,208,384,0.806722689
2156015,96,7,210,266,476,10,0,0.4,3.6,6,125,199,324,0.680672269
2156016,96,7,210,266,476,10,0,0.0,4.0,6,23,324,347,0.728991597
2156017,96,7,210,266,476,10,0,0.4,3.6,5,29,292,321,0.674369748
2156018,96,7,210,266,476,10,0,0.8,3.2,5,133,191,324,0.680672269
2156019,96,7,210,266,476,10,0,0.0,4.0,6,132,233,365,0.766806723
2156020,96,7,210,266,476,10,0,0.0,4.0,6,209,182,391,0.821428571
2156021,96,7,210,266,476,10,0,0.0,4.0,8,182,242,424,0.890756303
2156022,96,7,210,266,476,10,0,0.0,4.0,6,194,216,410,0.861344538
2156024,96,7,210,266,476,10,0,0.0,4.0,5,144,214,358,0.75210084
2156027,73,2,114,85,199,3,0,0.0,4.0,1,63,51,114,0.572864322
2157001,112,13,260,416,676,10,1,0.4,0.3,7,137,316,453,0.670118343
2157001,112,13,260,416,676,10,1,0.4,1.3,12,356,296,652,0.964497041
2157002,112,13,260,416,676,10,1,0.0,0.0,11,304,332,636,0.940828402
2157002,112,13,260,416,676,10,1,0.0,1.0,13,247,429,676,1.0
2157003,112,13,260,416,676,10,1,0.3,0.0,9,184,285,469,0.693786982
2157003,112,13,260,416,676,10,1,0.3,1.0,12,178,452,630,0.931952663
2157004,112,13,260,416,676,10,1,0.5,0.4,11,432,195,627,0.927514793
2157004,112,13,260,416,676,10,1,0.5,1.4,10,328,236,564,0.834319527
2157005,112,13,260,416,676,10,1,0.6,0.0,10,48,506,554,0.819526627
2157005,112,13,260,416,676,10,1,0.6,1.0,11,224,397,621,0.918639053
2158001,112,13,260,416,676,10,1,0.0,1.0,14,83,589,672,0.99408284
2158002,112,13,260,416,676,10,1,0.0,1.0,13,291,379,670,0.99112426
2158003,112,13,260,416,676,10,1,0.0,1.0,13,250,411,661,0.977810651
2158004,108,12,270,366,636,9,0,0.0,1.0,11,175,455,630,0.990566038
2159001,112,13,260,416,676,10,1,0.4,0.6,12,-302,915,613,0.906804734
2160001,94,15,525,735,1260,10,0,0.0,5.0,13,463,675,1138,0.903174603
2160002,94,15,525,735,1260,10,0,0.0,5.0,13,285,855,1140,0.904761905
2160003,81,6,315,321,636,5,0,0.0,5.0,6,217,359,576,0.905660377
2161001,112,13,260,416,676,10,1,0.0,0.0,10,36,509,545,0.806213018
2161002,112,13,260,416,676,10,1,0.0,0.0,10,-19,591,572,0.846153846
2161003,112,13,260,416,676,10,1,0.0,0.0,10,245,347,592,0.875739645
2161004,112,13,260,416,676,10,1,0.0,0.0,11,68,540,608,0.899408284
2162001,125,9,117,117,234,10,0,0.4,2.6,12,197,-35,162,0.692307692
2162002,125,9,117,117,234,10,0,0.2,2.8,8,82,90,172,0.735042735
2162003,125,9,117,117,234,10,0,0.2,2.7,8,-66,265,199,0.85042735
2162004,125,9,117,117,234,10,0,0.3,2.7,10,109,94,203,0.867521368
2162005,125,9,117,117,234,10,0,0.2,2.8,9,22,134,156,0.666666667
2162006,125,9,117,117,234,10,0,0.1,2.7,10,131,78,209,0.893162393
2162007,125,9,117,117,234,10,0,0.1,2.9,10,70,127,197,0.841880342
2162008,125,9,117,117,234,10,0,0.4,2.6,8,303,-113,190,0.811965812
2162009,125,9,117,117,234,10,0,0.6,2.4,10,75,65,140,0.598290598
2163001,65,13,780,390,1170,10,0,0.6,7.2,9,395,625,1020,0.871794872
2163001,65,13,780,390,1170,10,0,0.6,8.2,12,561,554,1115,0.952991453
2163002,65,13,780,390,1170,10,0,0.7,7.2,8,456,359,815,0.696581197
2163002,65,13,780,390,1170,10,0,0.7,8.2,10,516,409,925,0.790598291
2163006,57,3,234,126,360,3,0,1.0,6.6666665,2,73,232,305,0.847222222
2163006,57,3,234,126,360,3,0,1.0,7.6666665,2,108,167,275,0.763888889
2165001,112,13,260,416,676,10,1,0.0,11.0,13,138,478,616,0.911242604
2165002,112,13,260,416,676,10,1,0.0,9.9,13,220,440,660,0.976331361
2165003,112,13,260,416,676,10,1,0.0,10.0,13,260,396,656,0.970414201
2166001,112,13,260,416,676,10,1,0.2,0.8,9,24,507,531,0.785502959
2166002,112,13,260,416,676,10,1,1.3,1.7,14,49,605,654,0.967455621
2166003,111,6,135,201,336,4,0,0.25,0.75,3,59,193,252,0.75
2167001,112,13,260,416,676,10,1,0.4,3.6,10,221,389,610,0.902366864
2167002,112,13,260,416,676,10,1,0.0,4.0,9,161,386,547,0.809171598
2167003,112,13,260,416,676,10,1,0.0,4.0,11,355,264,619,0.915680473
2168001,108,12,300,390,690,8,0,0.0,12.875,4,-38,332,294,0.426086957
2168001,108,12,300,390,690,8,0,0.0,13.875,5,268,98,366,0.530434783
2168001,108,12,300,390,690,8,0,0.0,14.875,5,312,50,362,0.524637681
2168001,108,12,300,390,690,8,0,0.0,15.875,8,200,328,528,0.765217391
2168001,108,12,300,390,690,8,0,0.0,16.875,4,186,106,292,0.423188406
2168001,108,12,300,390,690,8,0,0.0,17.875,6,140,271,411,0.595652174
2168001,108,12,300,390,690,8,0,0.0,18.875,8,470,48,518,0.750724638
2168001,108,12,300,390,690,8,0,0.0,19.875,4,137,153,290,0.420289855
2168001,108,12,300,390,690,8,0,0.0,20.875,4,342,-50,292,0.423188406
2168001,108,12,300,390,690,8,0,0.0,21.875,5,-581,947,366,0.530434783
2169001,112,13,260,416,676,10,1,0.0,1.9,13,63,581,644,0.952662722
2169002,112,13,260,416,676,10,1,0.0,1.9,10,339,196,535,0.791420118
2169003,112,9,180,288,468,6,0,0.0,0.6666667,7,201,239,440,0.94017094
2170001,116,17,306,578,884,12,0,0.25,0.75,5,435,-79,356,0.402714932
2172001,112,13,260,416,676,10,1,0.2,0.7,12,304,350,654,0.967455621
2172001,112,13,260,416,676,10,1,0.2,1.7,13,238,422,660,0.976331361
2172002,112,13,260,416,676,10,1,0.1,0.9,12,422,247,669,0.98964497
2172002,112,13,260,416,676,10,1,0.1,1.9,14,348,324,672,0.99408284
2172003,112,13,260,416,676,10,1,0.0,1.0,14,357,303,660,0.976331361
2172003,112,13,260,416,676,10,1,0.0,2.0,14,477,195,672,0.99408284
2173001,116,23,506,759,1265,16,0,0.0,5.875,17,768,349,1117,0.883003953
2173001,116,23,506,759,1265,16,0,0.0,6.875,21,545,703,1248,0.986561265
2173002,116,23,506,759,1265,16,0,0.0625,6.25,19,434,714,1148,0.907509881
2173002,116,23,506,759,1265,16,0,0.0625,7.25,20,433,772,1205,0.95256917
2173003,116,23,506,759,1265,16,0,0.25,5.5,17,573,427,1000,0.790513834
2173003,116,23,506,759,1265,16,0,0.25,6.5,21,201,965,1166,0.92173913
2173004,116,23,506,759,1265,16,0,0.0,5.875,21,408,783,1191,0.941501976
2173004,116,23,506,759,1265,16,0,0.0,6.875,20,502,689,1191,0.941501976
2173005,116,23,506,759,1265,16,0,0.0,5.6875,21,617,590,1207,0.954150198
2173005,116,23,506,759,1265,16,0,0.0,6.6875,20,538,662,1200,0.948616601
2173006,116,23,506,759,1265,16,0,0.0,6.125,21,-50,1239,1189,0.939920949
2173006,116,23,506,759,1265,16,0,0.0,7.125,20,323,784,1107,0.875098814
2173007,116,23,506,759,1265,16,0,0.0,6.125,19,526,633,1159,0.916205534
2173007,116,23,506,759,1265,16,0,0.0,7.125,21,370,785,1155,0.913043478
2173008,116,23,506,759,1265,16,0,0.0,6.1875,20,601,632,1233,0.974703557
2173008,116,23,506,759,1265,16,0,0.0,7.1875,21,676,584,1260,0.996047431
2173009,116,23,506,759,1265,16,0,0.0,6.125,17,197,942,1139,0.900395257
2173009,116,23,506,759,1265,16,0,0.0,7.125,20,497,625,1122,0.886956522
2173010,111,12,360,453,813,9,0,0.0,7.7777777,10,256,492,748,0.9200492
2173010,115,15,375,525,900,10,0,0.0,8.7,14,528,358,886,0.984444444
2175001,141,12,378,564,942,10,0,0.0,2.9,14,516,396,912,0.968152866
2175002,141,12,378,564,942,10,0,0.0,3.0,12,559,365,924,0.98089172
2175003,141,10,325,486,811,8,0,0.0,3.0,10,817,-27,790,0.974106042
2176001,100,26,639,735,1374,19,0,0.0,4.7894735,21,660,570,1230,0.895196507
2177001,65,13,780,390,1170,10,0,0.8,6.6,7,287,568,855,0.730769231
2177001,65,13,780,390,1170,10,0,0.8,7.6,9,215,755,970,0.829059829
2177002,65,13,780,390,1170,10,0,0.7,6.6,7,212,548,760,0.64957265
2177002,65,13,780,390,1170,10,0,0.7,7.6,5,164,471,635,0.542735043
2177003,65,13,780,390,1170,10,0,0.2,6.3,9,183,847,1030,0.88034188
2177003,65,13,780,390,1170,10,0,0.2,7.3,8,354,581,935,0.799145299
2177004,65,13,780,390,1170,10,0,0.5,7.4,7,40,715,755,0.645299145
2177004,65,13,780,390,1170,10,0,0.5,8.4,9,63,642,705,0.602564103
2179001,161,2,20,17,37,10,0,2.0,7.0,6,273,-417,-144,-3.891891892
2179001,161,2,20,17,37,10,0,2.0,8.0,2,-8,11,3,0.081081081
2179001,161,2,20,17,37,10,0,2.0,9.0,3,-14,17,3,0.081081081
2179002,161,2,20,17,37,10,0,0.3,8.7,5,-60,-35,-95,-2.567567568
2179002,161,2,20,17,37,10,0,0.3,9.7,4,49,-103,-54,-1.459459459
2179002,161,2,20,17,37,10,0,0.3,10.7,6,-153,36,-117,-3.162162162
2179003,161,2,20,17,37,10,0,0.5,8.5,5,-6,-58,-64,-1.72972973
2179003,161,2,20,17,37,10,0,0.5,9.5,3,-5,-8,-13,-0.351351351
2179003,161,2,20,17,37,10,0,0.5,10.5,3,-91,17,-74,-2.0
2179004,161,2,20,17,37,10,0,2.3,6.7,4,-190,76,-114,-3.081081081
2179004,161,2,20,17,37,10,0,2.3,7.7,5,50,-176,-126,-3.405405405
2179004,161,2,20,17,37,10,0,2.3,8.7,6,-236,61,-175,-4.72972973
2181001,112,13,260,416,676,10,1,0.5,1.4,7,212,213,425,0.628698225
2181002,112,13,260,416,676,10,1,0.5,1.4,8,117,384,501,0.74112426
2182001,100,27,837,837,1674,18,0,0.0,1.0,27,2,1672,1674,1.0
2186001,108,126,2709,3858,6567,100,0,0.14,1.87,139,3129,2783,5912,0.90025887
2186002,108,126,2709,3858,6567,100,0,0.12,1.79,130,347,5496,5843,0.889751789
2186003,108,126,2709,3858,6567,100,0,0.17,1.8,135,2041,4071,6112,0.930714177
2186004,108,126,2709,3858,6567,100,0,0.24,1.59,123,-208,5869,5661,0.86203746
2186005,108,126,2709,3858,6567,100,0,0.25,1.58,127,937,4965,5902,0.898736105
2187001,120,26,650,650,1300,20,0,1.55,6.3,17,279,769,1048,0.806153846
2187001,120,26,650,650,1300,20,0,1.55,7.3,16,224,712,936,0.72
2187002,120,12,324,324,648,8,0,0.625,7.625,6,127,329,456,0.703703704
2187002,120,12,324,324,648,8,0,0.625,8.625,8,138,414,552,0.851851852
2188001,112,13,260,416,676,10,1,0.0,0.0,9,100,452,552,0.816568047
2188002,112,13,260,416,676,10,1,0.0,0.0,13,-10,624,614,0.908284024
2190001,100,17,578,578,1156,35,0,0.0,2.0285714,15,15,1017,1032,0.892733564
2191001,112,13,260,416,676,10,1,1.8,2.2,11,-71,647,576,0.852071006
2196001,116,34,595,1122,1717,24,0,0.0,0.0,29,1156,396,1552,0.903902155
2196002,116,34,595,1122,1717,24,0,0.0,0.0,30,234,1347,1581,0.920792079
2196003,116,34,595,1122,1717,24,0,0.0,0.0,27,653,823,1476,0.859638905
2196004,116,34,595,1122,1717,24,0,0.0,0.0,31,325,1251,1576,0.917880023
2196005,116,34,595,1122,1717,24,0,0.0,0.0,28,763,791,1554,0.905066977
2196006,116,34,595,1122,1717,24,0,0.0,0.0,30,620,964,1584,0.922539313
2196007,116,34,595,1122,1717,24,0,0.0,0.0,24,178,1158,1336,0.77810134
2196008,116,34,595,1122,1717,24,0,0.0,0.083333336,31,673,931,1604,0.934187536
2197001,112,13,260,416,676,10,1,0.0,0.0,13,151,457,608,0.899408284
2197002,112,13,260,416,676,10,1,0.0,0.0,10,30,509,539,0.797337278
2197003,112,13,260,416,676,10,1,0.0,0.0,11,350,200,550,0.813609467
2197004,112,13,260,416,676,10,1,0.0,0.0,11,-327,936,609,0.900887574
2197005,112,13,260,416,676,10,1,0.0,0.0,12,282,374,656,0.970414201
2197006,112,13,260,416,676,10,1,0.0,0.0,12,173,470,643,0.951183432
2197007,112,13,260,416,676,10,1,0.0,0.0,13,310,320,630,0.931952663
2197009,110,3,75,105,180,2,0,0.0,0.0,2,80,80,160,0.888888889
2199001,98,45,1260,1170,2430,19,0,0.0,8.894737,37,612,1547,2159,0.888477366
2202001,130,61,3660,3660,7320,20,0,0.0,1.0,63,2632,3616,6248,0.853551913
2202002,90,9,720,392,1112,3,0,0.0,0.33333334,4,76,698,774,0.696043165
2204001,123,19,1216,703,1919,15,0,0.0,10.0,21,953,929,1882,0.980719125
2204001,123,19,1216,703,1919,15,0,0.0,11.0,21,964,866,1830,0.953621678
2207001,105,12,276,330,606,25,0,0.0,5.0,7,8,330,338,0.557755776
2207002,100,1,50,50,100,3,0,0.0,2.0,1,75,25,100,1.0
2208001,500,32,8064,8064,16128,40,0,0.0,5.5,31,6749,5771,12520,0.776289683
2208002,500,32,8064,8064,16128,40,0,0.0,5.225,32,7427,4621,12048,0.74702381
2208003,500,32,8064,8064,16128,40,0,0.0,5.45,31,8622,3258,11880,0.736607143
2208004,500,32,8064,8064,16128,40,0,0.0,5.375,34,8095,5025,13120,0.813492063
2208005,500,32,8064,8064,16128,40,0,0.0,5.675,26,7249,5887,13136,0.814484127
2208006,500,32,8064,8064,16128,40,0,0.0,5.125,30,8463,3633,12096,0.75
2211001,111,6,135,201,336,4,0,0.0,0.75,5,87,232,319,0.949404762
2212001,112,13,260,416,676,10,1,1.1,7.2,11,208,395,603,0.892011834
2212002,112,13,260,416,676,10,1,1.1,7.1,10,184,388,572,0.846153846
2212003,112,13,260,416,676,10,1,1.5,6.8,13,217,459,676,1.0
2213001,110,21,420,630,1050,15,0,1.0,3.7333333,21,425,598,1023,0.974285714
2213002,110,21,420,630,1050,15,0,1.0,3.6666667,21,-301,1339,1038,0.988571429
2213003,110,21,420,630,1050,15,0,1.0,3.4,19,217,787,1004,0.956190476
2213004,110,21,420,630,1050,15,0,0.8666667,3.8666666,19,278,687,965,0.919047619
2213005,110,21,420,630,1050,15,0,0.93333334,3.9333334,21,533,496,1029,0.98
2213006,110,21,420,630,1050,15,0,0.8666667,3.8,20,-9,1024,1015,0.966666667
2213008,110,21,420,630,1050,15,0,0.73333335,3.6666667,21,-3,1026,1023,0.974285714
2213010,110,21,420,630,1050,15,0,1.1333333,3.4666667,20,348,654,1002,0.954285714
2213011,110,21,420,630,1050,15,0,0.93333334,3.6,17,74,829,903,0.86
2214001,112,13,260,416,676,10,1,1.1,3.9,13,219,436,655,0.968934911
2214001,112,13,260,416,676,10,1,1.1,4.9,13,264,385,649,0.960059172
2214002,112,13,260,416,676,10,1,1.1,3.9,12,250,407,657,0.971893491
2214002,112,13,260,416,676,10,1,1.1,4.9,13,323,330,653,0.965976331
2215001,116,17,306,578,884,12,0,0.0,3.5,15,292,546,838,0.947963801
2215002,116,17,306,578,884,12,0,0.0,3.0,17,441,435,876,0.990950226
2215003,116,17,306,578,884,12,0,0.0,3.5,9,183,299,482,0.545248869
2216001,112,13,260,416,676,10,1,0.0,4.8,9,40,420,460,0.680473373
2216002,112,13,260,416,676,10,1,0.0,5.1,11,338,271,609,0.900887574
2216003,112,13,260,416,676,10,1,0.0,5.0,12,410,211,621,0.918639053
2216005,112,13,260,416,676,10,1,0.3,4.5,11,-942,1474,532,0.786982249
2216006,112,13,260,416,676,10,1,0.0,4.8,10,368,115,483,0.714497041
2216007,112,13,260,416,676,10,1,0.0,5.2,14,111,550,661,0.977810651
2216008,112,13,260,416,676,10,1,0.2,5.3,9,303,150,453,0.670118343
2216009,112,13,260,416,676,10,1,0.0,5.2,6,143,181,324,0.479289941
2216010,112,13,260,416,676,10,1,0.0,5.1,6,107,296,403,0.596153846
2216011,112,13,260,416,676,10,1,0.2,4.3,9,514,-37,477,0.705621302
2217001,112,13,260,416,676,10,1,1.0,7.4,8,101,411,512,0.75739645
2217002,112,13,260,416,676,10,1,0.7,7.4,9,180,323,503,0.74408284
2217003,112,13,260,416,676,10,1,1.8,6.9,10,-34,624,590,0.872781065
2218001,350,11,825,825,1650,8,0,0.0,3.0,13,1398,117,1515,0.918181818
2218002,350,11,825,825,1650,8,0,0.0,3.0,12,942,423,1365,0.827272727
2218003,350,11,825,825,1650,8,0,0.0,3.0,12,312,648,960,0.581818182
2218004,350,11,825,825,1650,8,0,0.0,3.0,11,1222,203,1425,0.863636364
2218005,350,6,495,495,990,4,0,0.0,2.75,6,259,386,645,0.651515152
2222001,78,13,312,156,468,10,0,0.3,7.9,12,130,276,406,0.867521368
2222001,78,13,312,156,468,10,0,0.3,8.9,11,137,273,410,0.876068376
2222002,78,13,312,156,468,10,0,0.6,9.6,11,-48,462,414,0.884615385
2222002,78,13,312,156,468,10,0,0.6,10.6,7,33,247,280,0.598290598
2222003,78,13,312,156,468,10,0,1.4,9.6,9,163,173,336,0.717948718
2222003,78,13,312,156,468,10,0,1.4,10.6,10,375,-1,374,0.799145299
2222004,78,13,312,156,468,10,0,0.3,9.1,11,216,218,434,0.927350427
2222004,78,13,312,156,468,10,0,0.3,10.1,12,309,129,438,0.935897436
2222005,78,13,312,156,468,10,0,1.5,8.2,12,-35,457,422,0.901709402
2222005,78,13,312,156,468,10,0,1.5,9.2,14,-185,635,450,0.961538462
2224001,86,8,120,148,268,9,0,0.0,2.5555556,8,126,127,253,0.944029851
2224002,86,8,120,148,268,9,0,0.0,3.0,9,174,55,229,0.854477612
2225001,17,12,90,78,168,25,0,0.0,2.6,6,32,47,79,0.470238095
2225002,17,4,46,42,88,8,0,0.0,2.5,4,10,78,88,1.0
2227001,70,40,420,419,839,60,0,0.0,4.0,46,-216,435,219,0.26102503
2227002,70,40,420,419,839,60,0,0.0,4.016667,37,228,298,526,0.62693683
2227003,70,40,420,419,839,60,0,0.0,3.9833333,57,-973,915,-58,-0.069129917
2227004,80,11,56,255,311,20,0,0.0,4.1,14,48,117,165,0.530546624
2229001,112,13,260,416,676,10,1,0.0,0.0,9,327,249,576,0.852071006
2229002,112,13,260,416,676,10,1,0.0,0.0,8,237,290,527,0.779585799
2229003,112,13,260,416,676,10,1,0.0,0.0,11,122,436,558,0.825443787
2229004,111,6,135,201,336,4,0,0.0,0.0,4,144,148,292,0.869047619
2230001,3978,23,61916,42435,104351,17,0,0.0,6.882353,25,58344,41906,100250,0.960699945
2230001,3978,23,61916,42435,104351,17,0,0.0,7.882353,24,41114,56133,97247,0.931922071
2230001,3978,23,61916,42435,104351,17,0,0.0,8.882353,25,50612,49107,99719,0.95561135
2233001,116,34,595,1122,1717,14,0,2.642857,5.714286,27,882,589,1471,0.856726849
2234001,116,17,306,578,884,12,0,0.0,3.0,13,395,397,792,0.895927602
2234002,116,17,306,578,884,12,0,0.0,3.0,14,489,295,784,0.886877828
2235001,107,19,703,684,1387,14,0,0.14285715,1.8571428,18,727,607,1334,0.961788032
2235002,107,19,703,684,1387,14,0,0.2857143,1.7142857,20,502,870,1372,0.989185292
2236001,100,11,275,275,550,8,0,3.25,4.875,4,229,81,310,0.563636364
2236001,100,11,275,275,550,8,0,3.25,5.875,4,263,67,330,0.6
2237001,100,13,338,338,676,16,0,0.0,3.0,14,-26,594,568,0.840236686
2238001,112,13,260,416,676,10,1,1.0,2.9,10,271,343,614,0.908284024
2238002,112,13,260,416,676,10,1,1.0,2.2,8,8,523,531,0.785502959
2238003,112,13,260,416,676,10,1,1.0,2.0,8,433,87,520,0.769230769
2239001,50,7,182,182,364,20,0,0.0,2.0,8,-63,295,232,0.637362637
2240001,112,13,260,416,676,10,1,0.0,0.0,7,261,206,467,0.690828402
2240001,112,13,260,416,676,10,1,0.0,1.0,12,137,462,599,0.886094675
2240001,112,13,260,416,676,10,1,0.0,2.0,10,164,352,516,0.763313609
2240001,112,13,260,416,676,10,1,0.0,3.0,9,220,311,531,0.785502959
2240001,112,13,260,416,676,10,1,0.0,4.0,13,361,294,655,0.968934911
2241001,110,21,420,630,1050,15,0,1.3333334,2.4,8,218,331,549,0.522857143
2241002,110,21,420,630,1050,15,0,1.0666667,2.3333333,3,37,172,209,0.199047619
2241003,110,21,420,630,1050,15,0,1.0666667,2.4,7,-15,423,408,0.388571429
2243001,662,10,2380,1245,3625,34,0,0.0,13.735294,13,1051,1399,2450,0.675862069
2247001,116,17,306,578,884,12,0,0.0,0.0,9,-532,1070,538,0.608597285
2247001,116,17,306,578,884,12,0,0.0,1.0,14,327,461,788,0.891402715
2247001,116,17,306,578,884,12,0,0.0,2.0,3,183,87,270,0.305429864
2248001,112,13,260,416,676,10,1,0.1,0.9,13,208,442,650,0.961538462
2248002,112,13,260,416,676,10,1,0.1,0.9,10,200,376,576,0.852071006
2248003,112,13,260,416,676,10,1,0.0,1.0,8,521,-10,511,0.75591716
2248004,112,13,260,416,676,10,1,0.0,1.0,10,341,244,585,0.865384615
2248005,112,13,260,416,676,10,1,0.2,0.8,10,54,515,569,0.841715976
2249001,112,13,260,416,676,10,1,0.0,0.0,10,126,499,625,0.924556213
2249002,112,13,260,416,676,10,1,0.0,0.0,10,188,310,498,0.736686391
2249003,112,13,260,416,676,10,1,0.0,0.0,11,184,430,614,0.908284024
2249004,112,13,260,416,676,10,1,0.0,0.0,10,178,380,558,0.825443787
2249005,112,13,260,416,676,10,1,0.1,0.6,11,502,109,611,0.903846154
2249006,112,13,260,416,676,10,1,0.0,0.0,11,177,403,580,0.857988166
2249007,112,13,260,416,676,10,1,0.0,0.0,12,283,377,660,0.976331361
2249008,112,13,260,416,676,10,1,0.0,0.0,8,193,335,528,0.781065089
2249009,112,13,260,416,676,10,1,0.1,0.0,12,367,203,570,0.843195266
2252001,112,13,260,416,676,10,1,0.9,1.3,13,-62,724,662,0.979289941
2252002,112,13,260,416,676,10,1,0.0,1.6,13,352,246,598,0.884615385
2253001,154,60,2049,2070,4119,40,0,0.0,2.975,49,1794,1762,3556,0.863316339
2253002,154,60,2049,2070,4119,40,0,0.0,2.975,54,1811,2054,3865,0.938334547
2253003,154,60,2049,2070,4119,40,0,0.0,3.025,49,2492,1129,3621,0.879096868
2253004,154,60,2049,2070,4119,40,0,0.0,2.95,48,2785,636,3421,0.830541394
2253005,154,60,2049,2070,4119,40,0,0.0,2.9,44,1849,1416,3265,0.792668123
2253006,154,60,2049,2070,4119,40,0,0.0,2.925,48,2694,733,3427,0.831998058
2253007,154,60,2049,2070,4119,40,0,0.0,2.95,46,2530,880,3410,0.827870842
2253008,154,60,2049,2070,4119,40,0,0.0,2.95,50,2269,1319,3588,0.871085215
2253009,150,33,1155,1155,2310,22,0,0.0,2.909091,18,1262,230,1492,0.645887446
2254001,108,156,3492,4923,8415,60,0,0.13333334,6.483333,137,3620,3722,7342,0.872489602
2254002,108,156,3492,4923,8415,60,0,0.033333335,6.766667,127,3132,3765,6897,0.819607843
2254003,108,156,3492,4923,8415,60,0,0.11666667,6.4666667,117,3516,3066,6582,0.782174688
2254004,108,156,3492,4923,8415,60,0,0.06666667,6.383333,132,4286,2953,7239,0.860249554
2254005,108,145,3303,4616,7919,56,0,0.017857144,6.553571,110,690,5308,5998,0.757418866
2254006,105,39,972,1213,2185,15,0,0.0,6.8,27,1042,676,1718,0.786270023
2255001,112,13,260,416,676,10,1,0.8,6.5,9,239,292,531,0.785502959
2255001,112,13,260,416,676,10,1,0.8,7.5,8,199,287,486,0.718934911
2256001,218,15,2130,1500,3630,14,0,0.2857143,0.64285713,15,1494,1594,3088,0.850688705
2257001,662,10,2380,1245,3625,34,0,0.0,14.735294,11,2350,925,3275,0.903448276
2259001,112,13,260,416,676,10,1,0.1,0.8,7,148,351,499,0.73816568
2259002,112,13,260,416,676,10,1,0.1,0.8,7,107,371,478,0.707100592
2259003,112,13,260,416,676,10,1,0.1,0.9,12,-50,673,623,0.921597633
2259004,112,13,260,416,676,10,1,0.2,0.6,6,187,210,397,0.587278107
2261001,116,17,306,578,884,12,0,0.0,4.0,14,519,275,794,0.898190045
2261002,116,17,306,578,884,12,0,0.0,4.0,10,423,195,618,0.699095023
2264001,100,15,495,495,990,10,0,4.8,3.9,9,189,469,658,0.664646465
2264001,99,15,510,522,1032,11,0,4.7272725,4.6363635,11,362,467,829,0.803294574
2264001,100,18,585,585,1170,12,0,4.5,5.1666665,12,400,450,850,0.726495726
2264001,100,18,585,585,1170,12,0,4.5,6.1666665,11,336,495,831,0.71025641
2265001,100,12,330,330,660,8,0,3.25,6.875,8,290,237,527,0.798484848
2265001,100,12,330,330,660,8,0,3.25,7.875,9,124,464,588,0.890909091
2266001,112,21,693,672,1365,15,0,0.06666667,1.9333333,19,774,479,1253,0.917948718
2266002,112,21,693,672,1365,15,0,0.06666667,1.9333333,21,1035,303,1338,0.98021978
2267001,112,13,260,416,676,10,1,0.0,1.0,13,23,630,653,0.965976331
2269001,100,25,650,650,1300,10,0,0.0,11.3,13,177,639,816,0.627692308
2269001,100,25,650,650,1300,10,0,0.0,12.3,17,231,819,1050,0.807692308
2269001,100,25,650,650,1300,10,0,0.0,13.3,3,41,209,250,0.192307692
2270001,99,45,1260,1215,2475,31,0,0.0,1.967742,43,787,1601,2388,0.964848485
2272001,112,13,260,416,676,10,1,0.4,0.8,12,-99,752,653,0.965976331
2272002,112,13,260,416,676,10,1,0.0,1.0,12,13,613,626,0.926035503
2272003,112,13,260,416,676,10,1,0.1,0.9,13,298,346,644,0.952662722
2272004,112,13,260,416,676,10,1,0.3,0.9,14,283,384,667,0.986686391
2272005,112,13,260,416,676,10,1,0.1,1.1,13,207,449,656,0.970414201
2273001,116,17,306,578,884,12,0,0.33333334,0.6666667,15,260,594,854,0.966063348
2273002,116,17,306,578,884,12,0,0.25,0.75,14,229,583,812,0.918552036
2276001,112,13,260,416,676,10,1,0.2,2.8,14,223,449,672,0.99408284
2276002,112,13,260,416,676,10,1,0.4,2.6,13,357,257,614,0.908284024
2276003,112,13,260,416,676,10,1,0.6,2.4,14,417,240,657,0.971893491
2277001,65,13,780,390,1170,10,0,1.5,5.9,11,-158,1183,1025,0.876068376
2277001,65,13,780,390,1170,10,0,1.5,6.9,9,245,705,950,0.811965812
2277002,65,13,780,390,1170,10,0,1.3,6.7,10,153,912,1065,0.91025641
2277002,65,13,780,390,1170,10,0,1.3,7.7,11,181,924,1105,0.944444444
2278001,550,15,3750,3750,7500,20,0,0.0,1.15,20,-1425,3925,2500,0.333333333
2278002,550,15,3750,3750,7500,20,0,0.0,1.0,20,4086,414,4500,0.6
2278003,550,15,3750,3750,7500,20,0,0.0,1.1,15,2457,2843,5300,0.706666667
2278004,550,15,3750,3750,7500,20,0,0.0,0.95,19,4579,-2179,2400,0.32
2278005,550,15,3750,3750,7500,20,0,0.0,0.95,23,206,3694,3900,0.52
2278006,550,15,3750,3750,7500,20,0,0.0,1.0,19,1024,-124,900,0.12
2278007,550,15,3750,3750,7500,20,0,0.0,1.0,20,-101,2101,2000,0.266666667
2278008,550,15,3750,3750,7500,20,0,0.0,0.95,17,2949,1451,4400,0.586666667
2278009,550,15,3750,3750,7500,20,0,0.0,0.95,23,938,-638,300,0.04
2278010,550,15,3750,3750,7500,20,0,0.0,1.15,19,-2140,3640,1500,0.2
2278011,550,15,3750,3750,7500,20,0,0.0,1.0,25,-2035,4335,2300,0.306666667
2278012,550,15,3750,3750,7500,12,0,0.0,0.9166667,14,1998,4402,6400,0.853333333
2279001,550,11,1395,1395,2790,36,0,0.0,5.0,12,986,1113,2099,0.752329749
2280001,96,24,300,552,852,10,0,0.3,3.6,15,59,638,697,0.818075117
2280001,96,24,300,552,852,10,0,0.3,4.6,22,574,259,833,0.977699531
2280001,96,24,300,552,852,10,0,0.3,5.6,22,144,694,838,0.983568075
2280002,89,10,205,252,457,5,0,0.0,3.0,6,21,314,335,0.733041575
2280002,89,10,205,252,457,5,0,0.0,4.0,9,328,109,437,0.956236324
2280002,96,15,195,360,555,6,0,0.0,4.6666665,10,230,211,441,0.794594595
2281001,112,13,260,416,676,10,1,0.0,4.3,4,4,199,203,0.300295858
2281002,112,13,260,416,676,10,1,0.0,5.0,1,37,46,83,0.122781065
2281003,112,13,260,416,676,10,1,0.0,4.9,4,210,66,276,0.408284024
2281004,112,13,260,416,676,10,1,0.0,6.0,4,-130,396,266,0.393491124
2281005,112,13,260,416,676,10,1,0.0,4.4,3,-10,160,150,0.221893491
2282001,112,13,260,416,676,10,1,2.0,7.0,12,335,316,651,0.963017751
2282002,112,13,260,416,676,10,1,1.2,7.8,14,344,323,667,0.986686391
2282003,112,13,260,416,676,10,1,1.7,7.3,13,262,411,673,0.99556213
2282004,112,13,260,416,676,10,1,2.1,6.9,12,232,410,642,0.949704142
2283001,112,13,260,416,676,10,1,0.0,3.1,13,389,281,670,0.99112426
2283002,112,13,260,416,676,10,1,0.0,3.0,14,266,392,658,0.973372781
2283003,112,13,260,416,676,10,1,0.1,3.2,11,253,366,619,0.915680473
2283004,112,13,260,416,676,10,1,0.2,2.9,10,20,545,565,0.835798817
2283005,112,13,260,416,676,10,1,0.1,3.0,10,30,530,560,0.828402367
2283006,112,13,260,416,676,10,1,0.2,2.9,13,391,258,649,0.960059172
2283007,112,13,260,416,676,10,1,0.2,2.8,12,103,525,628,0.928994083
2283008,112,13,260,416,676,10,1,0.3,3.1,12,267,377,644,0.952662722
2283009,112,13,260,416,676,10,1,0.0,3.2,13,287,319,606,0.896449704
2283010,112,13,260,416,676,10,1,0.0,3.2,14,135,527,662,0.979289941
2283011,112,13,260,416,676,10,1,0.0,3.1,12,201,452,653,0.965976331
2283012,112,13,260,416,676,10,1,0.1,3.0,12,398,264,662,0.979289941
2283013,112,13,260,416,676,10,1,0.1,3.0,12,350,289,639,0.945266272
2283014,112,13,260,416,676,10,1,0.1,3.2,11,354,283,637,0.942307692
2283015,112,13,260,416,676,10,1,0.4,2.7,13,399,221,620,0.917159763
2284001,109,176,3604,5190,8794,137,0,0.0,0.99270076,97,709,4675,5384,0.612235615
2285001,107,15,330,435,765,11,0,0.0,7.2727275,7,21,432,453,0.592156863
2285002,107,15,330,435,765,11,0,0.0,6.909091,13,273,429,702,0.917647059
2286001,116,17,306,578,884,12,0,0.0,0.0,12,388,310,698,0.78959276
2286001,116,17,306,578,884,12,0,0.0,1.0,14,218,530,748,0.846153846
2286001,116,17,306,578,884,12,0,0.0,2.0,15,287,533,820,0.92760181
2286001,116,17,306,578,884,12,0,0.0,3.0,17,241,633,874,0.988687783
2286001,116,17,306,578,884,12,0,0.0,4.0,16,288,560,848,0.959276018
2286001,116,17,306,578,884,12,0,0.0,5.0,11,208,444,652,0.737556561
2286002,116,17,306,578,884,12,0,0.0,0.0,11,203,541,744,0.841628959
2286002,116,17,306,578,884,12,0,0.0,1.0,16,258,588,846,0.957013575
2286002,116,17,306,578,884,12,0,0.0,2.0,16,399,469,868,0.981900452
2286002,116,17,306,578,884,12,0,0.0,3.0,17,383,487,870,0.984162896
2286002,116,17,306,578,884,12,0,0.0,4.0,15,370,452,822,0.929864253
2286002,116,17,306,578,884,12,0,0.0,5.0,13,358,386,744,0.841628959
2286003,116,17,306,578,884,12,0,0.0,0.0,10,93,571,664,0.751131222
2286003,116,17,306,578,884,12,0,0.0,1.0,15,166,684,850,0.961538462
2286003,116,17,306,578,884,12,0,0.0,2.0,16,145,707,852,0.963800905
2286003,116,17,306,578,884,12,0,0.0,3.0,17,209,673,882,0.997737557
2286003,116,17,306,578,884,12,0,0.0,4.0,17,184,692,876,0.990950226
2286003,116,17,306,578,884,12,0,0.0,5.0,18,283,599,882,0.997737557
2286004,116,17,306,578,884,12,0,0.0,0.0,15,46,764,810,0.916289593
2286004,116,17,306,578,884,12,0,0.0,1.0,17,190,674,864,0.977375566
2286004,116,17,306,578,884,12,0,0.0,2.0,16,97,733,830,0.938914027
2286004,116,17,306,578,884,12,0,0.0,3.0,16,435,405,840,0.950226244
2286004,116,17,306,578,884,12,0,0.0,4.0,18,384,498,882,0.997737557
2286004,116,17,306,578,884,12,0,0.0,5.0,18,474,408,882,0.997737557
2287001,107,4,100,126,226,10,0,0.0,1.4,4,38,152,190,0.840707965
2287002,107,4,100,126,226,10,0,0.0,1.2,4,-221,389,168,0.743362832
2288001,65,13,780,390,1170,10,0,0.3,7.2,11,343,652,995,0.85042735
2288001,65,13,780,390,1170,10,0,0.3,8.2,12,349,761,1110,0.948717949
2288002,65,13,780,390,1170,10,0,0.6,7.1,13,379,781,1160,0.991452991
2288002,65,13,780,390,1170,10,0,0.6,8.1,9,271,554,825,0.705128205
2288003,65,13,780,390,1170,10,0,1.0,5.8,12,-13,913,900,0.769230769
2288003,65,13,780,390,1170,10,0,1.0,6.8,12,633,342,975,0.833333333
2288005,70,3,195,120,315,2,0,1.0,6.5,3,202,113,315,1.0
2288005,70,3,195,120,315,2,0,1.0,7.5,3,262,53,315,1.0
2289001,78,13,312,156,468,10,0,1.5,10.7,11,71,375,446,0.952991453
2289001,78,13,312,156,468,10,0,1.5,11.7,12,147,307,454,0.97008547
2289002,78,13,312,156,468,10,0,1.8,8.9,13,209,245,454,0.97008547
2289002,78,13,312,156,468,10,0,1.8,9.9,14,214,240,454,0.97008547
2289003,78,13,312,156,468,10,0,1.5,9.0,9,114,298,412,0.88034188
2289003,78,13,312,156,468,10,0,1.5,10.0,11,170,240,410,0.876068376
2289004,78,13,312,156,468,10,0,1.1,9.9,13,274,180,454,0.97008547
2289004,78,13,312,156,468,10,0,1.1,10.9,14,259,187,446,0.952991453
2289005,78,13,312,156,468,10,0,1.3,8.3,12,-65,481,416,0.888888889
2289005,78,13,312,156,468,10,0,1.3,9.3,9,150,210,360,0.769230769
2290001,110,13,234,390,624,10,0,0.0,3.1,12,235,368,603,0.966346154
2290002,110,13,234,390,624,10,0,0.0,3.0,12,58,560,618,0.990384615
2290003,110,13,234,390,624,10,0,0.2,2.7,11,238,295,533,0.854166667
2292001,112,13,260,416,676,10,1,0.6,3.4,11,227,409,636,0.940828402
2292002,112,13,260,416,676,10,1,0.2,3.8,10,122,500,622,0.920118343
2292003,112,13,260,416,676,10,1,0.6,3.3,7,171,291,462,0.683431953
2294001,103,25,725,725,1450,10,0,0.0,2.9,24,817,617,1434,0.988965517
2294001,103,25,725,725,1450,10,0,0.0,3.9,20,404,886,1290,0.889655172
2294001,103,25,725,725,1450,10,0,0.0,4.9,23,706,698,1404,0.968275862
2294002,103,25,725,725,1450,10,0,0.0,3.9,20,205,1035,1240,0.855172414
2294002,103,25,725,725,1450,10,0,0.0,4.9,17,872,284,1156,0.797241379
2294002,103,25,725,725,1450,10,0,0.0,5.9,20,558,714,1272,0.877241379
2294003,103,25,725,725,1450,10,0,0.0,3.9,21,520,800,1320,0.910344828
2294003,103,25,725,725,1450,10,0,0.0,4.9,15,414,568,982,0.677241379
2294003,103,25,725,725,1450,10,0,0.0,5.9,23,847,569,1416,0.976551724
2294004,103,10,320,320,640,4,0,0.0,3.0,5,302,84,386,0.603125
2294004,103,10,320,320,640,4,0,0.0,4.0,8,233,351,584,0.9125
2294004,103,10,320,320,640,4,0,0.0,5.0,5,382,60,442,0.690625
2295001,95,6,180,150,330,5,0,0.0,4.0,5,63,247,310,0.939393939
2295002,95,6,180,150,330,5,0,0.8,3.2,6,140,158,298,0.903030303
2295003,95,6,180,150,330,5,0,0.0,4.0,6,189,125,314,0.951515152
2295004,95,6,180,150,330,5,0,0.0,4.0,6,257,73,330,1.0
2295005,95,6,180,150,330,5,0,0.8,3.2,4,132,134,266,0.806060606
2295006,95,6,180,150,330,5,0,0.0,4.0,6,179,135,314,0.951515152
2296001,121,5,75,55,130,10,0,0.5,9.9,3,78,-24,54,0.415384615
2296001,121,5,75,55,130,10,0,0.5,10.9,4,119,-21,98,0.753846154
2296002,121,5,75,55,130,10,0,0.9,9.5,4,-29,47,18,0.138461538
2296002,121,5,75,55,130,10,0,0.9,10.5,8,-144,145,1,0.007692308
2297001,110,21,420,630,1050,14,0,0.85714287,1.1428572,18,560,421,981,0.934285714
2298001,100,42,1239,1239,2478,28,0,0.0,3.8214285,18,987,278,1265,0.510492333
2298001,100,42,1239,1239,2478,28,0,0.0,4.821429,28,784,1023,1807,0.729217111
2298001,100,42,1239,1239,2478,28,0,0.0,5.821429,24,711,802,1513,0.610573043
2298001,100,42,1239,1239,2478,28,0,0.0,6.821429,26,403,1237,1640,0.661824052
2298001,100,42,1239,1239,2478,28,0,0.0,7.821429,23,-354,1822,1468,0.592413236
2298002,100,3,108,108,216,2,0,0.0,3.0,1,150,-50,100,0.462962963
2298002,100,3,108,108,216,2,0,0.0,4.0,1,-4,104,100,0.462962963
2298002,93,3,129,114,243,3,0,0.0,4.3333335,3,-57,273,216,0.888888889
2298002,93,3,129,114,243,3,0,0.0,5.3333335,1,-64,164,100,0.411522634
2300001,78,13,312,156,468,10,0,0.9,7.8,7,-19,303,284,0.606837607
2300001,78,13,312,156,468,10,0,0.9,8.8,13,-35,459,424,0.905982906
2300002,78,13,312,156,468,10,0,1.1,8.0,10,4,418,422,0.901709402
2300002,78,13,312,156,468,10,0,1.1,9.0,7,-58,360,302,0.645299145
2300003,78,13,312,156,468,10,0,2.1,9.0,8,-143,451,308,0.658119658
2300003,78,13,312,156,468,10,0,2.1,10.0,6,-20,270,250,0.534188034
2300004,78,9,216,108,324,6,0,1.5,8.5,2,6,124,130,0.401234568
2302001,316,3,201,189,390,7,0,3.7142856,1.0,2,140,71,211,0.541025641
2302001,316,3,201,189,390,7,0,3.7142856,2.0,3,165,225,390,1.0
2302001,316,3,201,189,390,7,0,3.7142856,3.0,3,223,167,390,1.0
2302001,316,3,201,189,390,7,0,3.7142856,4.0,3,205,185,390,1.0
2302001,316,3,201,189,390,7,0,3.7142856,5.0,3,225,165,390,1.0
2306001,112,15,330,510,840,11,0,0.09090909,5.0,9,245,361,606,0.721428571
2307001,77,24,624,876,1500,16,0,0.0625,2.9375,15,236,979,1215,0.81
2307002,77,24,624,876,1500,16,0,0.0,3.0625,15,281,920,1201,0.800666667
2307003,77,24,624,876,1500,16,0,0.1875,2.9375,17,197,1096,1293,0.862
2307004,77,24,624,876,1500,16,0,0.125,3.0625,21,450,948,1398,0.932
2307005,77,24,624,876,1500,16,0,0.0,3.0625,19,-19,1418,1399,0.932666667
2307006,77,24,624,876,1500,16,0,0.1875,3.0625,17,401,935,1336,0.890666667
2307007,77,24,624,876,1500,16,0,0.3125,2.8125,18,352,1013,1365,0.91
2307008,77,24,624,876,1500,16,0,0.0625,3.0,17,154,1183,1337,0.891333333
2307009,77,24,624,876,1500,16,0,0.25,2.875,19,348,1059,1407,0.938
2307010,77,24,624,876,1500,16,0,0.8125,2.4375,14,125,1045,1170,0.78
2307011,77,24,624,876,1500,16,0,0.8125,2.5625,19,309,1072,1381,0.920666667
2308001,218,13,1872,1326,3198,12,0,1.4166666,6.5,10,840,1395,2235,0.698874296
2308001,218,13,1872,1326,3198,12,0,1.4166666,7.5,11,-374,2898,2524,0.789243277
2308001,218,13,1872,1326,3198,12,0,1.4166666,8.5,10,1505,1108,2613,0.817073171
2308002,218,13,1872,1326,3198,12,0,1.6666666,6.3333335,10,1418,1510,2928,0.915572233
2308002,218,13,1872,1326,3198,12,0,1.6666666,7.3333335,10,1273,1367,2640,0.825515947
2308002,218,13,1872,1326,3198,12,0,1.6666666,8.333333,11,2089,885,2974,0.929956223
2309001,94,12,342,264,606,12,0,4.5,6.5,12,203,403,606,1.0
2309001,94,12,342,264,606,12,0,4.5,7.5,11,249,315,564,0.930693069
2310001,96,10,155,235,390,10,0,3.1,2.9,9,126,180,306,0.784615385
2310001,96,10,155,235,390,10,0,3.1,3.9,10,83,278,361,0.925641026
2310001,96,10,155,235,390,10,0,3.1,4.9,7,36,241,277,0.71025641
2310002,96,10,155,235,390,10,0,3.3,2.5,7,47,245,292,0.748717949
2310002,96,10,155,235,390,10,0,3.3,3.5,8,-47,342,295,0.756410256
2310002,96,10,155,235,390,10,0,3.3,4.5,10,83,260,343,0.879487179
2311001,86,36,1620,1620,3240,18,0,0.0,5.0,32,1544,1432,2976,0.918518519
2312001,112,13,260,416,676,10,1,2.0,7.0,13,110,546,656,0.970414201
2312002,112,13,260,416,676,10,1,2.0,6.5,10,101,435,536,0.792899408
2313001,112,13,260,416,676,10,1,0.2,5.7,12,309,324,633,0.936390533
2313002,112,13,260,416,676,10,1,0.3,5.5,12,297,369,666,0.985207101
2313003,112,13,260,416,676,10,1,0.1,5.5,11,324,285,609,0.900887574
2313004,112,13,260,416,676,10,1,0.4,5.0,11,264,297,561,0.829881657
2313005,112,13,260,416,676,10,1,0.1,5.6,12,305,293,598,0.884615385
2313006,112,13,260,416,676,10,1,0.3,5.5,14,261,399,660,0.976331361
2313007,112,13,260,416,676,10,1,0.0,5.6,14,324,335,659,0.974852071
2313008,112,13,260,416,676,10,1,0.1,5.5,13,198,434,632,0.934911243
2313009,112,13,260,416,676,10,1,0.0,5.7,10,393,190,583,0.862426036
2313010,112,13,260,416,676,10,1,0.4,5.4,13,317,336,653,0.965976331
2313011,112,13,260,416,676,10,1,0.3,5.3,12,340,294,634,0.937869822
2313012,112,13,260,416,676,10,1,0.0,5.8,15,711,-51,660,0.976331361
2313013,112,13,260,416,676,10,1,0.3,4.8,12,553,88,641,0.948224852
2313014,112,13,260,416,676,10,1,0.5,5.3,14,97,566,663,0.980769231
2313015,112,13,260,416,676,10,1,0.3,4.7,14,794,-148,646,0.955621302
2314001,112,13,260,416,676,10,1,3.8,2.4,14,36,620,656,0.970414201
2314001,112,13,260,416,676,10,1,3.8,3.4,14,280,379,659,0.974852071
2314001,112,13,260,416,676,10,1,3.8,4.4,13,241,421,662,0.979289941
2314002,112,13,260,416,676,10,1,4.2,1.8,13,283,370,653,0.965976331
2314002,112,13,260,416,676,10,1,4.2,2.8,13,268,385,653,0.965976331
2314002,112,13,260,416,676,10,1,4.2,3.8,14,389,280,669,0.98964497
2315001,96,10,155,235,390,10,0,0.5,1.3,12,60,298,358,0.917948718
2315001,96,10,155,235,390,10,0,0.5,2.3,11,65,309,374,0.958974359
2315002,96,10,155,235,390,10,0,0.4,1.8,11,66,307,373,0.956410256
2315002,96,10,155,235,390,10,0,0.4,2.8,11,55,312,367,0.941025641
2315003,96,10,155,235,390,10,0,0.5,2.6,9,168,196,364,0.933333333
2315003,96,10,155,235,390,10,0,0.5,3.6,11,136,231,367,0.941025641
2315004,96,10,155,235,390,10,0,0.2,1.9,11,-51,402,351,0.9
2315004,96,10,155,235,390,10,0,0.2,2.9,8,58,248,306,0.784615385
2315005,96,10,155,235,390,10,0,0.2,1.8,11,93,236,329,0.843589744
2315005,96,10,155,235,390,10,0,0.2,2.8,10,95,273,368,0.943589744
2316001,105,23,529,529,1058,48,0,0.0,0.0,22,411,595,1006,0.950850662
2317001,96,7,210,266,476,10,0,0.0,1.0,4,121,183,304,0.638655462
2317001,96,7,210,266,476,10,0,0.0,2.0,7,147,283,430,0.903361345
2317001,96,7,210,266,476,10,0,0.0,3.0,8,102,303,405,0.850840336
2317001,96,7,210,266,476,10,0,0.0,4.0,7,189,271,460,0.966386555
2317002,96,7,210,266,476,10,0,0.0,1.0,7,162,282,444,0.932773109
2317002,96,7,210,266,476,10,0,0.0,2.0,5,139,192,331,0.695378151
2317002,96,7,210,266,476,10,0,0.0,3.0,7,188,269,457,0.960084034
2317002,96,7,210,266,476,10,0,0.0,4.0,6,113,309,422,0.886554622
2317003,96,7,210,266,476,10,0,0.0,1.0,6,121,162,283,0.594537815
2317003,96,7,210,266,476,10,0,0.0,2.0,6,236,185,421,0.884453782
2317003,96,7,210,266,476,10,0,0.0,3.0,7,170,266,436,0.915966387
2317003,96,7,210,266,476,10,0,0.0,4.0,7,94,245,339,0.712184874
2317004,96,7,210,266,476,10,0,0.1,0.8,6,63,337,400,0.840336134
2317004,96,7,210,266,476,10,0,0.1,1.8,7,329,128,457,0.960084034
2317004,96,7,210,266,476,10,0,0.1,2.8,5,68,253,321,0.674369748
2317004,96,7,210,266,476,10,0,0.1,3.8,7,240,198,438,0.920168067
2317005,96,7,210,266,476,10,0,0.1,0.9,6,456,-95,361,0.758403361
2317005,96,7,210,266,476,10,0,0.1,1.9,6,-135,432,297,0.62394958
2317005,96,7,210,266,476,10,0,0.1,2.9,5,190,111,301,0.632352941
2317005,96,7,210,266,476,10,0,0.1,3.9,8,135,309,444,0.932773109
2317006,96,7,210,266,476,10,0,0.1,0.9,4,136,182,318,0.668067227
2317006,96,7,210,266,476,10,0,0.1,1.9,8,110,290,400,0.840336134
2317006,96,7,210,266,476,10,0,0.1,2.9,8,195,257,452,0.949579832
2317006,96,7,210,266,476,10,0,0.1,3.9,7,81,384,465,0.976890756
2317007,96,7,210,266,476,10,0,0.0,1.0,6,239,226,465,0.976890756
2317007,96,7,210,266,476,10,0,0.0,2.0,4,34,252,286,0.600840336
2317007,96,7,210,266,476,10,0,0.0,3.0,6,166,261,427,0.897058824
2317007,96,7,210,266,476,10,0,0.0,4.0,6,108,289,397,0.834033613
2317008,96,7,210,266,476,10,0,0.0,1.0,5,127,208,335,0.703781513
2317008,96,7,210,266,476,10,0,0.0,2.0,7,306,83,389,0.817226891
2317008,96,7,210,266,476,10,0,0.0,3.0,6,104,337,441,0.926470588
2317008,96,7,210,266,476,10,0,0.0,4.0,7,74,324,398,0.836134454
2317009,96,7,210,266,476,10,0,0.0,1.0,6,109,270,379,0.796218487
2317009,96,7,210,266,476,10,0,0.0,2.0,4,80,188,268,0.56302521
2317009,96,7,210,266,476,10,0,0.0,3.0,8,-160,590,430,0.903361345
2317009,96,7,210,266,476,10,0,0.0,4.0,8,45,347,392,0.823529412
2317010,96,7,210,266,476,10,0,0.0,1.0,4,118,257,375,0.787815126
2317010,96,7,210,266,476,10,0,0.0,2.0,5,104,237,341,0.716386555
2317010,96,7,210,266,476,10,0,0.0,3.0,6,130,214,344,0.722689076
2317010,96,7,210,266,476,10,0,0.0,4.0,6,209,204,413,0.867647059
2317011,96,7,210,266,476,10,0,0.0,1.0,2,17,165,182,0.382352941
2317011,96,7,210,266,476,10,0,0.0,2.0,4,88,208,296,0.621848739
2317011,96,7,210,266,476,10,0,0.0,3.0,6,109,323,432,0.907563025
2317011,96,7,210,266,476,10,0,0.0,4.0,6,160,249,409,0.859243697
2317012,96,7,210,266,476,10,0,0.1,0.9,5,172,197,369,0.775210084
2317012,96,7,210,266,476,10,0,0.1,1.9,7,217,166,383,0.804621849
2317012,96,7,210,266,476,10,0,0.1,2.9,5,134,237,371,0.779411765
2317012,96,7,210,266,476,10,0,0.1,3.9,7,193,127,320,0.672268908
2317013,96,7,210,266,476,10,0,0.1,0.9,4,109,176,285,0.598739496
2317013,96,7,210,266,476,10,0,0.1,1.9,7,163,187,350,0.735294118
2317013,96,7,210,266,476,10,0,0.1,2.9,8,156,296,452,0.949579832
2317013,96,7,210,266,476,10,0,0.1,3.9,8,153,296,449,0.943277311
2317014,96,7,210,266,476,10,0,0.0,1.0,6,221,206,427,0.897058824
2317014,96,7,210,266,476,10,0,0.0,2.0,7,150,304,454,0.953781513
2317014,96,7,210,266,476,10,0,0.0,3.0,7,141,255,396,0.831932773
2317014,96,7,210,266,476,10,0,0.0,4.0,6,217,180,397,0.834033613
2317015,96,7,210,266,476,10,0,0.0,1.0,6,116,349,465,0.976890756
2317015,96,7,210,266,476,10,0,0.0,2.0,5,128,253,381,0.800420168
2317015,96,7,210,266,476,10,0,0.0,3.0,7,111,241,352,0.739495798
2317015,96,7,210,266,476,10,0,0.0,4.0,7,191,258,449,0.943277311
2317016,96,7,210,266,476,10,0,0.0,1.0,6,310,34,344,0.722689076
2317016,96,7,210,266,476,10,0,0.0,2.0,5,190,111,301,0.632352941
2317016,96,7,210,266,476,10,0,0.0,3.0,7,305,111,416,0.87394958
2317016,96,7,210,266,476,10,0,0.0,4.0,7,-92,469,377,0.792016807
2317017,96,7,210,266,476,10,0,0.0,1.0,2,87,79,166,0.348739496
2317017,96,7,210,266,476,10,0,0.0,2.0,6,196,237,433,0.909663866
2317017,96,7,210,266,476,10,0,0.0,3.0,6,182,185,367,0.771008403
2317017,96,7,210,266,476,10,0,0.0,4.0,7,243,21,264,0.554621849
2317018,96,7,210,266,476,10,0,0.0,1.0,3,81,215,296,0.621848739
2317018,96,7,210,266,476,10,0,0.0,2.0,5,187,229,416,0.87394958
2317018,96,7,210,266,476,10,0,0.0,3.0,7,129,317,446,0.93697479
2317018,96,7,210,266,476,10,0,0.0,4.0,6,122,280,402,0.844537815
2317019,96,7,210,266,476,10,0,0.0,1.0,5,202,140,342,0.718487395
2317019,96,7,210,266,476,10,0,0.0,2.0,5,-95,345,250,0.525210084
2317019,96,7,210,266,476,10,0,0.0,3.0,6,153,222,375,0.787815126
2317019,96,7,210,266,476,10,0,0.0,4.0,7,116,300,416,0.87394958
2317020,96,7,210,266,476,10,0,0.1,0.9,5,164,207,371,0.779411765
2317020,96,7,210,266,476,10,0,0.1,1.9,5,102,167,269,0.56512605
2317020,96,7,210,266,476,10,0,0.1,2.9,7,154,236,390,0.819327731
2317020,96,7,210,266,476,10,0,0.1,3.9,7,204,168,372,0.781512605
2317021,96,7,210,266,476,10,0,0.1,0.9,4,88,200,288,0.605042017
2317021,96,7,210,266,476,10,0,0.1,1.9,8,222,148,370,0.777310924
2317021,96,7,210,266,476,10,0,0.1,2.9,4,87,146,233,0.489495798
2317021,96,7,210,266,476,10,0,0.1,3.9,8,170,276,446,0.93697479
2317022,96,7,210,266,476,10,0,0.0,1.0,4,126,187,313,0.657563025
2317022,96,7,210,266,476,10,0,0.0,2.0,5,158,177,335,0.703781513
2317022,96,7,210,266,476,10,0,0.0,3.0,7,91,353,444,0.932773109
2317022,96,7,210,266,476,10,0,0.0,4.0,6,-22,421,399,0.838235294
2317023,96,7,210,266,476,10,0,0.0,1.0,6,65,314,379,0.796218487
2317023,96,7,210,266,476,10,0,0.0,2.0,7,117,335,452,0.949579832
2317023,96,7,210,266,476,10,0,0.0,3.0,5,173,174,347,0.728991597
2317023,96,7,210,266,476,10,0,0.0,4.0,6,168,267,435,0.913865546
2317024,96,7,210,266,476,10,0,0.0,1.0,6,247,172,419,0.880252101
2317024,96,7,210,266,476,10,0,0.0,2.0,8,214,156,370,0.777310924
2317024,96,7,210,266,476,10,0,0.0,3.0,5,196,201,397,0.834033613
2317024,96,7,210,266,476,10,0,0.0,4.0,6,163,225,388,0.81512605
2319001,122,10,145,190,335,14,0,0.21428572,2.7857144,9,143,139,282,0.841791045
2319002,122,10,145,190,335,14,0,0.2857143,2.7142856,10,169,70,239,0.713432836
2324001,105,12,276,330,606,9,0,0.11111111,3.0,7,161,330,491,0.810231023
2324001,105,12,276,330,606,9,0,0.11111111,4.0,11,227,378,605,0.998349835
2324002,109,3,75,102,177,2,0,0.0,3.0,1,46,54,100,0.564971751
2325001,675,11,1395,1395,2790,36,0,0.0,6.0,13,1030,1183,2213,0.793189964
2326001,200,28,2972,2972,5944,24,0,0.0,0.5,38,2883,1607,4490,0.75538358
2326001,200,28,2972,2972,5944,24,0,0.0,1.5,30,2136,3396,5532,0.930686406
2326001,200,28,2972,2972,5944,24,0,0.0,2.5,32,2379,3011,5390,0.90679677
2326001,200,28,2972,2972,5944,24,0,0.0,3.5,33,2316,3312,5628,0.946837147
2331001,120,64,2368,2368,4736,32,0,0.0,3.03125,52,2159,2215,4374,0.923564189
2332001,96,10,155,235,390,10,0,0.5,2.5,10,141,226,367,0.941025641
2332001,96,10,155,235,390,10,0,0.5,3.5,13,87,241,328,0.841025641
2332002,96,10,155,235,390,10,0,0.9,2.1,12,302,45,347,0.88974359
2332002,96,10,155,235,390,10,0,0.9,3.1,12,328,13,341,0.874358974
2332003,96,10,155,235,390,10,0,0.9,2.1,11,-27,365,338,0.866666667
2332003,96,10,155,235,390,10,0,0.9,3.1,12,100,262,362,0.928205128
2333001,112,13,260,416,676,10,1,0.0,1.0,10,127,478,605,0.894970414
2333001,112,13,260,416,676,10,1,0.0,2.0,12,183,471,654,0.967455621
2333002,112,13,260,416,676,10,1,0.0,1.0,11,143,499,642,0.949704142
2333002,112,13,260,416,676,10,1,0.0,2.0,12,300,348,648,0.958579882
2333003,112,13,260,416,676,10,1,0.0,1.0,14,38,613,651,0.963017751
2333003,112,13,260,416,676,10,1,0.0,2.0,14,154,518,672,0.99408284
2336001,112,13,260,416,676,10,1,0.0,2.0,12,151,476,627,0.927514793
2336002,112,13,260,416,676,10,1,0.0,2.0,11,246,351,597,0.883136095
2336003,112,13,260,416,676,10,1,0.0,2.0,14,475,197,672,0.99408284
2337001,112,13,260,416,676,10,1,0.7,2.3,12,-252,865,613,0.906804734
2337002,112,13,260,416,676,10,1,0.7,2.3,13,-447,1109,662,0.979289941
2337003,112,13,260,416,676,10,1,0.4,2.4,13,22,615,637,0.942307692
2338001,110,11,220,330,550,10,0,0.0,2.8,9,28,448,476,0.865454545
2338002,110,11,220,330,550,10,0,0.0,2.9,9,-53,553,500,0.909090909
2338003,110,11,220,330,550,10,0,0.0,2.9,10,174,308,482,0.876363636
2338004,110,11,220,330,550,10,0,0.0,2.9,8,156,332,488,0.887272727
2338005,110,11,220,330,550,10,0,0.0,3.0,9,193,291,484,0.88
2338006,110,5,112,168,280,4,0,0.0,2.75,2,141,49,190,0.678571429
2340001,78,13,312,156,468,10,0,1.9,10.2,6,157,147,304,0.64957265
2340001,78,13,312,156,468,10,0,1.9,11.2,5,96,156,252,0.538461538
2340002,78,13,312,156,468,10,0,1.5,11.0,6,67,247,314,0.670940171
2340002,78,13,312,156,468,10,0,1.5,12.0,6,11,289,300,0.641025641
2340003,78,13,312,156,468,10,0,0.9,9.8,8,196,136,332,0.709401709
2340003,78,13,312,156,468,10,0,0.9,10.8,5,168,14,182,0.388888889
2341001,112,9,180,288,468,6,0,1.0,1.0,9,549,-81,468,1.0
2343001,45,36,630,630,1260,30,0,0.0,2.0,40,400,573,973,0.772222222
2344001,107,4,100,126,226,10,0,0.0,11.3,3,118,83,201,0.889380531
2344001,107,4,100,126,226,10,0,0.0,12.3,3,118,83,201,0.889380531
2344002,102,2,84,87,171,5,0,0.0,14.0,2,97,57,154,0.900584795
2344002,102,2,84,87,171,5,0,0.0,15.0,2,78,59,137,0.801169591
2345001,112,13,260,416,676,10,1,2.5,10.0,11,173,474,647,0.957100592
2345001,112,13,260,416,676,10,1,2.5,11.0,10,178,435,613,0.906804734
2345002,112,13,260,416,676,10,1,2.3,9.0,8,157,350,507,0.75
2345002,112,13,260,416,676,10,1,2.3,10.0,12,111,539,650,0.961538462
2345003,112,13,260,416,676,10,1,2.8,7.1,12,321,334,655,0.968934911
2345003,112,13,260,416,676,10,1,2.8,8.1,7,122,293,415,0.613905325
2347001,100,45,1260,1260,2520,30,0,0.0,0.0,43,756,1680,2436,0.966666667
2347002,100,21,672,672,1344,14,0,0.0,0.0,12,397,502,899,0.66889881
2349001,500,8,2012,2012,4024,10,0,0.0,4.6,5,1631,458,2089,0.519135189
2349002,464,6,1725,1577,3302,7,0,0.0,4.714286,4,81,1434,1515,0.458812841
2350001,135,5,45,95,140,10,0,0.0,4.0,6,45,37,82,0.585714286
2350002,135,5,45,95,140,10,0,0.0,3.9,7,181,-208,-27,-0.192857143
2350003,129,4,60,68,128,7,0,0.0,4.0,6,-42,131,89,0.6953125
2351001,550,6,1545,1545,3090,20,0,0.4,4.65,7,623,1596,2219,0.718122977
2351002,550,6,1545,1545,3090,20,0,0.4,4.3,9,1779,238,2017,0.652750809
2351003,550,6,1545,1545,3090,20,0,0.1,5.0,9,1622,703,2325,0.752427184
2351004,550,6,1545,1545,3090,20,0,0.2,4.5,7,568,1497,2065,0.66828479
2351005,550,6,1545,1545,3090,20,0,0.05,4.95,9,82,2089,2171,0.702588997
2351006,550,6,1545,1545,3090,20,0,0.1,4.9,7,1129,1937,3066,0.99223301
2351007,550,6,1545,1545,3090,20,0,0.25,4.75,7,1718,1348,3066,0.99223301
2351008,550,6,1545,1545,3090,20,0,0.1,4.65,5,384,1498,1882,0.609061489
2351009,550,6,1545,1545,3090,20,0,0.05,4.85,8,569,1549,2118,0.685436893
2351010,550,6,1545,1545,3090,20,0,0.8,4.35,7,1706,1283,2989,0.967313916
2352001,65,13,780,390,1170,10,0,0.2,6.8,9,330,690,1020,0.871794872
2352001,65,13,780,390,1170,10,0,0.2,7.8,6,218,492,710,0.606837607
2352002,65,13,780,390,1170,10,0,0.7,6.2,9,218,757,975,0.833333333
2352002,65,13,780,390,1170,10,0,0.7,7.2,9,263,717,980,0.837606838
2352003,65,13,780,390,1170,10,0,1.0,6.0,9,176,724,900,0.769230769
2352003,65,13,780,390,1170,10,0,1.0,7.0,11,-186,1141,955,0.816239316
2352004,65,13,780,390,1170,10,0,0.4,6.2,7,204,676,880,0.752136752
2352004,65,13,780,390,1170,10,0,0.4,7.2,7,198,707,905,0.773504274
2352005,65,13,780,390,1170,10,0,0.9,6.1,9,-265,1090,825,0.705128205
2352005,65,13,780,390,1170,10,0,0.9,7.1,12,-427,1397,970,0.829059829
2353001,107,15,330,435,765,11,0,0.0,1.8181819,12,286,385,671,0.877124183
2353002,107,15,330,435,765,11,0,0.0,1.7272727,12,223,476,699,0.91372549
2354001,212,23,805,1311,2116,16,0,0.625,5.0625,17,693,1172,1865,0.881379962
2354002,212,23,805,1311,2116,16,0,1.125,4.375,20,408,1581,1989,0.939981096
2354003,212,23,805,1311,2116,16,0,1.125,4.3125,17,766,1042,1808,0.854442344
2355001,44,31,573,543,1116,25,0,0.0,1.12,38,607,320,927,0.830645161
2356001,212,54,7857,3084,10941,37,0,0.0,1.0,44,5327,3765,9132,0.834658624
2359001,65,13,780,390,1170,10,0,0.1,5.5,8,324,526,850,0.726495726
2359001,65,13,780,390,1170,10,0,0.1,6.5,9,361,649,1010,0.863247863
2359002,65,13,780,390,1170,10,0,0.5,5.5,8,48,827,875,0.747863248
2359002,65,13,780,390,1170,10,0,0.5,6.5,9,278,787,1065,0.91025641
2359003,65,13,780,390,1170,10,0,0.3,5.7,9,313,712,1025,0.876068376
2359003,65,13,780,390,1170,10,0,0.3,6.7,10,355,710,1065,0.91025641
2360001,124,15,375,585,960,10,0,0.0,1.6,11,318,467,785,0.817708333
2360002,124,15,375,585,960,10,0,0.0,1.0,10,562,160,722,0.752083333
2360003,124,15,375,585,960,10,0,0.0,1.3,13,523,389,912,0.95
2360004,124,15,375,585,960,10,0,0.0,1.3,14,211,723,934,0.972916667
2360005,124,15,375,585,960,10,0,0.0,1.3,11,687,187,874,0.910416667
2361001,44,31,573,543,1116,25,0,0.0,2.12,39,575,360,935,0.83781362
2362001,108,156,3492,4923,8415,60,0,0.06666667,7.383333,117,2608,4388,6996,0.831372549
2362002,108,156,3492,4923,8415,60,0,0.05,7.5666666,130,2052,5482,7534,0.895306001
2362003,108,156,3492,4923,8415,60,0,0.06666667,7.6,139,2341,5473,7814,0.928579917
2362004,108,156,3492,4923,8415,60,0,0.0,7.616667,136,3194,4318,7512,0.892691622
2362005,108,156,3492,4923,8415,60,0,0.11666667,7.5,132,2923,4497,7420,0.881758764
2362006,104,33,864,1044,1908,13,0,0.46153846,6.6153846,23,340,950,1290,0.676100629
2363001,95,6,180,150,330,5,0,0.0,0.0,6,174,156,330,1.0
2364001,118,14,602,497,1099,10,0,1.2,2.8,14,502,591,1093,0.994540491
2365001,100,13,314,314,628,26,0,0.0,2.8846154,11,85,479,564,0.898089172
2367001,112,13,260,416,676,10,1,0.0,2.0,9,308,196,504,0.74556213
2367002,112,13,260,416,676,10,1,0.0,2.0,6,56,298,354,0.523668639
2367003,111,6,135,201,336,4,0,0.0,1.75,3,75,169,244,0.726190476
2369001,112,13,260,416,676,10,1,0.3,2.2,15,250,410,660,0.976331361
2369002,112,13,260,416,676,10,1,0.6,1.9,14,373,276,649,0.960059172
2369003,112,13,260,416,676,10,1,0.1,1.8,11,162,403,565,0.835798817
2369004,112,13,260,416,676,10,1,0.3,2.0,13,10,616,626,0.926035503
2369005,112,13,260,416,676,10,1,0.5,2.3,15,344,316,660,0.976331361
2369006,112,13,260,416,676,10,1,0.4,2.4,14,119,530,649,0.960059172
2371001,112,13,260,416,676,10,1,0.4,3.5,9,135,341,476,0.704142012
2371002,112,13,260,416,676,10,1,0.0,3.8,10,141,404,545,0.806213018
2371003,112,13,260,416,676,10,1,0.2,3.8,11,-93,724,631,0.933431953
2371004,112,13,260,416,676,10,1,0.2,3.7,9,-6,482,476,0.704142012
2371005,112,13,260,416,676,10,1,0.2,3.6,10,-234,790,556,0.822485207
2371006,112,13,260,416,676,10,1,0.2,3.7,10,179,373,552,0.816568047
2371007,112,11,223,357,580,8,0,0.25,3.625,7,42,403,445,0.767241379
2372001,108,9,198,270,468,10,0,1.7,20.1,10,163,241,404,0.863247863
2372002,108,9,198,270,468,10,0,2.6,17.5,7,152,207,359,0.767094017
2372003,108,9,198,270,468,10,0,1.3,21.7,10,115,320,435,0.929487179
2373001,112,13,260,416,676,10,1,0.0,0.0,13,449,208,657,0.971893491
2374001,114,22,968,715,1683,22,0,3.0,0.0,16,214,1134,1348,0.800950683
2374001,114,22,968,715,1683,22,0,3.0,1.0,24,469,1063,1532,0.910279263
2374001,114,22,968,715,1683,22,0,3.0,2.0,22,742,860,1602,0.951871658
2374001,114,22,968,715,1683,22,0,3.0,3.0,21,782,869,1651,0.980986334
2374001,114,22,968,715,1683,22,0,3.0,4.0,20,771,824,1595,0.947712418
2376001,120,11,165,385,550,25,0,4.8,8.64,10,284,129,413,0.750909091
2376001,120,11,165,385,550,25,0,4.8,9.64,11,55,365,420,0.763636364
2376001,120,11,165,385,550,25,0,4.8,10.64,11,403,47,450,0.818181818
2378001,241,24,1476,1728,3204,12,0,0.0,3.0833333,26,3053,-2,3051,0.952247191
2384001,112,13,260,416,676,10,1,0.4,3.6,12,491,140,631,0.933431953
2384003,112,13,260,416,676,10,1,1.2,2.8,11,495,150,645,0.954142012
2384005,110,3,75,105,180,2,0,2.0,2.0,3,99,81,180,1.0
2390001,100,38,1197,1197,2394,77,0,0.0,0.0,38,1597,760,2357,0.984544695
2391001,105,23,529,529,1058,47,0,0.0,1.0,19,-49,971,922,0.871455577
2391001,105,23,529,529,1058,47,0,0.0,2.0,20,305,605,910,0.860113422
2391001,105,23,529,529,1058,48,0,0.0,2.9583333,15,342,390,732,0.691871456
2392001,95,6,180,150,330,5,0,0.0,5.0,3,141,79,220,0.666666667
2392002,95,6,180,150,330,5,0,0.0,5.0,2,43,131,174,0.527272727
2392003,95,6,180,150,330,5,0,0.0,5.0,2,155,11,166,0.503030303
2392004,95,6,180,150,330,5,0,0.2,4.8,2,30,142,172,0.521212121
2392005,95,6,180,150,330,5,0,0.8,4.2,3,112,86,198,0.6
2392006,95,6,180,150,330,5,0,0.2,4.8,3,101,129,230,0.696969697
2393001,78,13,312,156,468,10,0,1.1,8.8,4,53,187,240,0.512820513
2393001,78,13,312,156,468,10,0,1.1,9.8,6,47,283,330,0.705128205
2393002,78,13,312,156,468,10,0,1.1,8.9,5,119,113,232,0.495726496
2393002,78,13,312,156,468,10,0,1.1,9.9,8,50,328,378,0.807692308
2393003,78,13,312,156,468,10,0,2.5,6.8,7,33,269,302,0.645299145
2393003,78,13,312,156,468,10,0,2.5,7.8,6,-332,602,270,0.576923077
2393004,78,13,312,156,468,10,0,1.3,7.4,7,42,312,354,0.756410256
2393004,78,13,312,156,468,10,0,1.3,8.4,7,38,336,374,0.799145299
2393005,75,6,174,84,258,5,0,0.8,9.2,4,69,135,204,0.790697674
2394001,112,13,260,416,676,10,1,0.0,1.0,12,216,412,628,0.928994083
2394002,112,13,260,416,676,10,1,0.1,0.9,10,246,347,593,0.877218935
2395001,112,13,260,416,676,10,1,0.0,1.9,10,265,312,577,0.853550296
2395002,112,13,260,416,676,10,1,0.0,2.0,14,86,583,669,0.98964497
2395003,112,13,260,416,676,10,1,0.0,1.7,11,328,235,563,0.832840237
2395004,97,3,114,111,225,3,0,0.0,2.0,2,64,86,150,0.666666667
2398001,65,13,94,117,211,26,0,7.3461537,5.6923075,7,-184,274,90,0.426540284
2399001,78,13,312,156,468,10,0,0.4,8.2,13,197,259,456,0.974358974
2399001,78,13,312,156,468,10,0,0.4,9.2,9,76,274,350,0.747863248
2399002,78,13,312,156,468,10,0,1.1,7.5,11,188,238,426,0.91025641
2399002,78,13,312,156,468,10,0,1.1,8.5,11,210,202,412,0.88034188
2399003,78,13,312,156,468,10,0,1.1,7.4,11,11,401,412,0.88034188
2399003,78,13,312,156,468,10,0,1.1,8.4,7,131,171,302,0.645299145
2399004,78,13,312,156,468,10,0,0.3,7.7,13,197,255,452,0.965811966
2399004,78,13,312,156,468,10,0,0.3,8.7,12,210,208,418,0.893162393
2401001,100,25,650,650,1300,10,0,0.0,1.0,14,545,415,960,0.738461538
2401002,100,25,650,650,1300,10,0,0.0,1.0,13,756,190,946,0.727692308
2401003,100,25,650,650,1300,10,0,0.0,1.0,11,231,623,854,0.656923077
2403001,110,11,220,330,550,8,0,0.875,7.125,9,165,369,534,0.970909091
2404001,90,6,195,135,330,10,0,1.9,20.7,5,76,244,320,0.96969697
2404001,90,6,195,135,330,10,0,1.9,21.7,6,128,195,323,0.978787879
2404002,90,6,195,135,330,10,0,1.4,21.5,5,127,165,292,0.884848485
2404002,90,6,195,135,330,10,0,1.4,22.5,6,156,160,316,0.957575758
2404003,90,6,195,135,330,10,0,2.2,19.5,6,110,206,316,0.957575758
2404003,90,6,195,135,330,10,0,2.2,20.5,6,49,223,272,0.824242424
2406001,107,4,100,126,226,10,0,0.0,9.7,4,82,120,202,0.89380531
2406001,107,4,100,126,226,10,0,0.0,10.7,3,28,161,189,0.836283186
2406001,107,4,100,126,226,10,0,0.0,11.7,4,40,162,202,0.89380531
2406002,107,4,100,126,226,10,0,0.0,8.3,2,54,76,130,0.575221239
2406002,107,4,100,126,226,10,0,0.0,9.3,3,56,121,177,0.783185841
2406002,107,4,100,126,226,10,0,0.0,10.3,1,14,45,59,0.261061947
2406003,107,4,100,126,226,10,0,0.0,8.6,4,-38,240,202,0.89380531
2406003,107,4,100,126,226,10,0,0.0,9.6,3,26,175,201,0.889380531
2406003,107,4,100,126,226,10,0,0.0,10.6,2,6,112,118,0.522123894
2406004,107,4,100,126,226,10,0,0.0,7.3,3,66,111,177,0.783185841
2406004,107,4,100,126,226,10,0,0.0,8.3,2,19,87,106,0.469026549
2406004,107,4,100,126,226,10,0,0.0,9.3,1,-16,46,30,0.132743363
2406005,107,4,100,126,226,10,0,0.0,8.6,2,84,87,171,0.756637168
2406005,107,4,100,126,226,10,0,0.0,9.6,2,40,44,84,0.371681416
2406005,107,4,100,126,226,10,0,0.0,10.6,1,27,61,88,0.389380531
2407001,112,13,260,416,676,10,1,0.8,1.6,12,161,458,619,0.915680473
2407002,112,13,260,416,676,10,1,0.8,1.6,10,324,205,529,0.782544379
2407003,112,13,260,416,676,10,1,0.7,1.4,10,160,382,542,0.801775148
2409001,112,13,260,416,676,10,1,0.0,3.0,11,468,128,596,0.881656805
2409002,112,13,260,416,676,10,1,0.0,3.0,12,455,199,654,0.967455621
2409003,112,13,260,416,676,10,1,0.0,2.9,9,205,328,533,0.788461538
2409004,112,13,260,416,676,10,1,0.0,3.0,5,-318,676,358,0.529585799
2409005,112,13,260,416,676,10,1,0.0,3.7,5,230,86,316,0.467455621
2409006,112,13,260,416,676,10,1,0.0,2.8,5,58,268,326,0.482248521
2410001,120,26,650,650,1300,20,0,1.4,8.0,18,772,360,1132,0.870769231
2410001,120,26,650,650,1300,20,0,1.4,9.0,20,749,397,1146,0.881538462
2410002,120,12,324,324,648,8,0,1.0,10.375,8,408,184,592,0.913580247
2411001,116,17,306,578,884,12,0,0.5833333,4.4166665,6,524,-26,498,0.563348416
2412001,53,2,59,42,101,6,0,4.3333335,6.0,2,-9,82,73,0.722772277
2413001,116,17,306,578,884,12,0,0.0,0.0,15,340,498,838,0.947963801
2414001,112,13,260,416,676,10,1,2.0,0.0,8,230,280,510,0.75443787
2416001,110,21,420,630,1050,16,0,0.0625,3.875,21,334,656,990,0.942857143
2416002,110,21,420,630,1050,16,0,0.125,3.875,20,195,824,1019,0.97047619
2416003,110,21,420,630,1050,16,0,0.125,3.875,21,438,466,904,0.860952381
2416004,110,21,420,630,1050,16,0,0.375,3.625,21,598,427,1025,0.976190476
2416005,110,21,420,630,1050,16,0,0.125,3.875,23,489,529,1018,0.96952381
2416006,110,21,420,630,1050,16,0,0.0625,4.25,24,530,490,1020,0.971428571
2416007,110,21,420,630,1050,16,0,0.0625,3.9375,21,420,616,1036,0.986666667
2418006,112,13,260,416,676,10,1,0.2,3.8,12,247,401,648,0.958579882
2419001,104,9,234,270,504,7,0,0.0,2.857143,9,441,45,486,0.964285714
2420001,112,13,260,247,507,10,0,0.0,1.0,12,320,154,474,0.934911243
2420002,112,13,260,247,507,10,0,0.0,0.9,13,431,58,489,0.964497041
2420003,112,13,260,247,507,10,0,0.0,1.0,12,134,349,483,0.952662722
2420004,112,13,260,247,507,10,0,0.0,1.0,14,386,112,498,0.982248521
2420005,106,6,165,123,288,5,0,0.0,1.0,5,201,45,246,0.854166667
2421001,111,6,135,201,336,4,0,0.0,1.75,3,104,107,211,0.62797619
2422001,112,13,260,416,676,10,1,1.0,6.0,14,522,139,661,0.977810651
2422002,112,13,260,416,676,10,1,2.1,6.2,12,358,251,609,0.900887574
2422003,112,13,260,416,676,10,1,3.3,10.7,12,335,272,607,0.897928994
2423001,112,13,260,416,676,10,1,0.0,0.0,11,177,355,532,0.786982249
2423001,112,13,260,416,676,10,1,0.0,1.0,14,250,402,652,0.964497041
2423001,112,13,260,416,676,10,1,0.0,2.0,12,333,327,660,0.976331361
2423001,112,13,260,416,676,10,1,0.0,3.0,14,258,408,666,0.985207101
2423002,112,13,260,416,676,10,1,0.0,0.0,11,70,538,608,0.899408284
2423002,112,13,260,416,676,10,1,0.0,1.0,14,198,465,663,0.980769231
2423002,112,13,260,416,676,10,1,0.0,2.0,13,173,481,654,0.967455621
2423002,112,13,260,416,676,10,1,0.0,3.0,13,261,396,657,0.971893491
2423003,112,13,260,416,676,10,1,0.0,0.0,14,297,348,645,0.954142012
2423003,112,13,260,416,676,10,1,0.0,1.0,13,257,401,658,0.973372781
2423003,112,13,260,416,676,10,1,0.0,2.0,12,312,320,632,0.934911243
2423003,112,13,260,416,676,10,1,0.0,3.0,12,298,356,654,0.967455621
2423004,112,13,260,416,676,10,1,0.0,0.0,11,132,408,540,0.798816568
2423004,112,13,260,416,676,10,1,0.0,1.0,14,156,507,663,0.980769231
2423004,112,13,260,416,676,10,1,0.0,2.0,14,49,606,655,0.968934911
2423004,112,13,260,416,676,10,1,0.0,3.0,13,172,491,663,0.980769231
2423005,112,13,260,416,676,10,1,0.0,0.0,12,34,530,564,0.834319527
2423005,112,13,260,416,676,10,1,0.0,1.0,13,156,497,653,0.965976331
2423005,112,13,260,416,676,10,1,0.0,2.0,11,132,466,598,0.884615385
2423005,112,13,260,416,676,10,1,0.0,3.0,14,348,324,672,0.99408284
2423006,112,13,260,416,676,10,1,0.0,0.0,13,-729,1351,622,0.920118343
2423006,112,13,260,416,676,10,1,0.0,1.0,15,265,395,660,0.976331361
2423006,112,13,260,416,676,10,1,0.0,2.0,13,50,574,624,0.923076923
2423006,112,13,260,416,676,10,1,0.0,3.0,11,394,182,576,0.852071006
2423007,112,13,260,416,676,10,1,0.0,0.0,10,-179,695,516,0.763313609
2423007,112,13,260,416,676,10,1,0.0,1.0,12,200,416,616,0.911242604
2423007,112,13,260,416,676,10,1,0.0,2.0,11,126,436,562,0.831360947
2423007,112,13,260,416,676,10,1,0.0,3.0,13,130,536,666,0.985207101
2423008,112,13,260,416,676,10,1,0.0,0.0,13,-104,736,632,0.934911243
2423008,112,13,260,416,676,10,1,0.0,1.0,11,155,415,570,0.843195266
2423008,112,13,260,416,676,10,1,0.0,2.0,14,271,378,649,0.960059172
2423008,112,13,260,416,676,10,1,0.0,3.0,14,183,460,643,0.951183432
2423009,112,13,260,416,676,10,1,0.0,0.0,8,285,219,504,0.74556213
2423009,112,13,260,416,676,10,1,0.0,1.0,9,263,207,470,0.695266272
2423009,112,13,260,416,676,10,1,0.0,2.0,10,349,259,608,0.899408284
2423009,112,13,260,416,676,10,1,0.0,3.0,9,203,364,567,0.838757396
2423010,112,13,260,416,676,10,1,0.0,0.0,10,148,435,583,0.862426036
2423010,112,13,260,416,676,10,1,0.0,1.0,11,176,418,594,0.878698225
2423010,112,13,260,416,676,10,1,0.0,2.0,13,396,263,659,0.974852071
2423010,112,13,260,416,676,10,1,0.0,3.0,14,364,284,648,0.958579882
2425001,75,26,975,325,1300,25,0,0.0,0.0,35,846,235,1081,0.831538462
2425002,77,3,111,42,153,2,0,0.0,0.0,2,26,125,151,0.986928105
2426001,112,13,260,416,676,10,1,0.0,0.0,12,137,496,633,0.936390533
2426002,112,13,260,416,676,10,1,0.0,0.0,10,16,574,590,0.872781065
2426003,112,13,260,416,676,10,1,0.0,0.0,11,413,163,576,0.852071006
2426004,112,9,180,288,468,6,0,0.0,0.0,6,190,191,381,0.814102564
2427001,112,13,260,416,676,10,1,0.0,0.0,7,250,187,437,0.646449704
2427001,112,13,260,416,676,10,1,0.0,1.0,14,436,222,658,0.973372781
2427001,112,13,260,416,676,10,1,0.0,2.0,12,380,271,651,0.963017751
2427002,112,13,260,416,676,10,1,0.0,0.0,11,-15,575,560,0.828402367
2427002,112,13,260,416,676,10,1,0.0,1.0,13,306,325,631,0.933431953
2427002,112,13,260,416,676,10,1,0.0,2.0,12,463,145,608,0.899408284
2427003,112,13,260,416,676,10,1,0.0,0.0,6,117,238,355,0.525147929
2427003,112,13,260,416,676,10,1,0.0,1.0,10,191,372,563,0.832840237
2427003,112,13,260,416,676,10,1,0.0,2.0,12,429,195,624,0.923076923
2427004,112,13,260,416,676,10,1,0.0,0.0,4,100,206,306,0.452662722
2427004,112,13,260,416,676,10,1,0.0,1.0,10,243,344,587,0.868343195
2427004,112,13,260,416,676,10,1,0.0,2.0,12,171,459,630,0.931952663
2427005,112,13,260,416,676,10,1,0.0,0.0,11,-5,608,603,0.892011834
2427005,112,13,260,416,676,10,1,0.0,1.0,13,369,275,644,0.952662722
2427005,112,13,260,416,676,10,1,0.0,2.0,12,356,297,653,0.965976331
2427006,112,13,260,416,676,10,1,0.0,0.0,8,206,333,539,0.797337278
2427006,112,13,260,416,676,10,1,0.0,1.0,10,197,331,528,0.781065089
2427006,112,13,260,416,676,10,1,0.0,2.0,11,224,368,592,0.875739645
2427008,97,3,114,111,225,3,0,0.0,0.0,1,-2,102,100,0.444444444
2428001,78,52,1317,647,1964,40,0,0.0,2.0,35,89,1435,1524,0.775967413
2428001,78,52,1317,647,1964,40,0,0.0,3.0,37,-63,1607,1544,0.786150713
2428002,78,52,1317,647,1964,40,0,0.0,1.95,31,218,1315,1533,0.780549898
2428002,78,52,1317,647,1964,40,0,0.0,2.95,27,285,1125,1410,0.717922607
2428003,78,52,1317,647,1964,40,0,0.0,2.0,37,-9,1563,1554,0.791242363
2428003,78,52,1317,647,1964,40,0,0.0,3.0,39,152,1541,1693,0.862016293
2428004,78,52,1317,647,1964,40,0,0.0,2.0,33,127,1345,1472,0.749490835
2428004,78,52,1317,647,1964,40,0,0.0,3.0,33,68,1322,1390,0.707739308
2428006,78,52,1317,647,1964,40,0,0.0,2.0,38,-70,1584,1514,0.770875764
2428006,78,52,1317,647,1964,40,0,0.0,3.0,29,108,1178,1286,0.654786151
2429001,112,13,260,416,676,10,1,0.0,1.0,11,199,366,565,0.835798817
2429002,112,13,260,416,676,10,1,0.0,1.0,9,-48,453,405,0.599112426
2429003,112,13,260,416,676,10,1,0.0,1.0,14,329,340,669,0.98964497
2429004,112,13,260,416,676,10,1,0.0,1.0,12,24,543,567,0.838757396
2429005,112,13,260,416,676,10,1,0.1,1.6,12,487,129,616,0.911242604
2429006,112,13,260,416,676,10,1,0.0,1.0,13,241,351,592,0.875739645
2429007,112,13,260,416,676,10,1,0.0,1.0,13,212,454,666,0.985207101
2429008,112,13,260,416,676,10,1,0.0,1.0,8,183,207,390,0.576923077
2429009,112,13,260,416,676,10,1,0.1,1.0,12,167,413,580,0.857988166
2430001,110,11,220,330,550,8,0,0.0,0.0,12,620,-80,540,0.981818182
2431001,112,13,260,416,676,10,1,0.0,1.9,10,390,198,588,0.869822485
2431002,112,13,260,416,676,10,1,0.0,1.6,13,-27,691,664,0.982248521
2431003,112,13,260,416,676,10,1,0.0,1.8,13,-161,763,602,0.890532544
2432001,112,13,260,416,676,10,1,0.0,2.0,11,450,204,654,0.967455621
2432002,112,13,260,416,676,10,1,0.0,3.3,6,259,121,380,0.562130178
2432003,111,6,135,201,336,4,0,0.0,2.0,4,77,215,292,0.869047619
2433001,112,13,260,416,676,10,1,0.3,2.7,11,351,268,619,0.915680473
2433002,112,13,260,416,676,10,1,0.9,2.1,12,287,308,595,0.880177515
2433003,112,13,260,416,676,10,1,0.4,2.6,13,231,415,646,0.955621302
2433004,112,13,260,416,676,10,1,0.2,2.8,11,206,362,568,0.840236686
2433005,112,13,260,416,676,10,1,0.3,2.7,11,328,293,621,0.918639053
2434001,110,11,220,330,550,8,0,0.0,1.0,10,499,-3,496,0.901818182
2435001,112,13,260,416,676,10,1,0.0,0.0,11,151,368,519,0.767751479
2435001,112,13,260,416,676,10,1,0.0,1.0,10,206,295,501,0.74112426
2435002,112,13,260,416,676,10,1,0.0,0.0,13,210,442,652,0.964497041
2435002,112,13,260,416,676,10,1,0.0,1.0,10,161,427,588,0.869822485
2436001,114,30,645,1050,1695,20,0,0.2,1.8,28,503,1150,1653,0.975221239
2436002,114,30,645,1050,1695,20,0,0.0,2.0,24,547,900,1447,0.853687316
2436003,114,30,645,1050,1695,20,0,0.1,1.9,29,579,1096,1675,0.98820059
2436004,114,30,645,1050,1695,20,0,0.0,2.0,28,635,1009,1644,0.969911504
2436005,114,30,645,1050,1695,20,0,0.0,2.0,28,925,718,1643,0.969321534
2436006,114,30,645,1050,1695,20,0,0.0,2.0,25,-158,1646,1488,0.877876106
2436007,114,30,645,1050,1695,20,0,0.1,1.9,28,66,1579,1645,0.970501475
2436008,114,30,645,1050,1695,20,0,0.1,1.9,26,655,827,1482,0.874336283
2436009,114,30,645,1050,1695,20,0,0.0,2.0,24,329,1152,1481,0.873746313
2437001,117,14,952,483,1435,10,0,1.0,1.8,14,604,831,1435,1.0
2437002,117,14,952,483,1435,10,0,0.7,2.1,13,870,435,1305,0.909407666
2438001,112,13,260,416,676,10,1,0.1,0.9,12,203,463,666,0.985207101
2438001,112,13,260,416,676,10,1,0.1,1.9,13,243,418,661,0.977810651
2438002,112,13,260,416,676,10,1,0.1,0.9,12,185,476,661,0.977810651
2438002,112,13,260,416,676,10,1,0.1,1.9,14,263,401,664,0.982248521
2439001,112,13,260,416,676,10,1,2.0,0.0,12,286,386,672,0.99408284
2440001,65,13,780,390,1170,10,0,0.3,5.7,14,12,1138,1150,0.982905983
2440002,65,13,780,390,1170,10,0,0.3,5.7,15,-915,2040,1125,0.961538462
2440003,65,13,780,390,1170,10,0,0.4,5.3,13,-541,1651,1110,0.948717949
2441001,107,8,176,232,408,6,0,0.0,1.8333334,8,142,258,400,0.980392157
2443001,108,9,198,270,468,10,0,3.4,18.4,9,155,234,389,0.831196581
2443002,108,9,198,270,468,10,0,3.1,17.5,10,62,353,415,0.886752137
2443003,108,9,198,270,468,10,0,4.0,16.8,7,140,273,413,0.882478632
2444001,112,13,260,416,676,10,1,0.1,2.9,11,191,405,596,0.881656805
2444002,112,13,260,416,676,10,1,0.3,2.7,11,19,581,600,0.887573964
2444004,112,13,260,416,676,10,1,0.2,2.7,12,311,319,630,0.931952663
2444005,112,13,260,416,676,10,1,0.1,2.9,13,281,360,641,0.948224852
2446002,95,20,616,500,1116,5,0,9.4,8.4,17,332,549,881,0.789426523
2446002,95,20,616,500,1116,5,0,9.4,9.4,18,401,598,999,0.89516129
2447001,112,13,260,416,676,10,1,0.0,0.0,12,80,481,561,0.829881657
2447002,112,13,260,416,676,10,1,0.0,0.0,14,-33,691,658,0.973372781
2447003,112,13,260,416,676,10,1,0.0,0.0,14,-96,749,653,0.965976331
2447004,112,13,260,416,676,10,1,0.0,0.0,12,390,196,586,0.866863905
2447005,112,13,260,416,676,10,1,0.0,0.0,13,368,259,627,0.927514793
2447006,112,13,260,416,676,10,1,0.0,0.0,13,116,550,666,0.985207101
2447007,112,13,260,416,676,10,1,0.0,0.0,10,90,501,591,0.874260355
2447008,112,13,260,416,676,10,1,0.0,0.0,13,267,340,607,0.897928994
2447009,112,13,260,416,676,10,1,0.0,0.0,14,424,239,663,0.980769231
2447010,112,13,260,416,676,10,1,0.0,0.0,11,348,273,621,0.918639053
2447011,112,13,260,416,676,10,1,0.0,0.0,12,672,-79,593,0.877218935
2447012,112,13,260,416,676,10,1,0.0,0.0,14,82,563,645,0.954142012
2447013,112,13,260,416,676,10,1,0.0,0.0,11,248,370,618,0.914201183
2447014,112,13,260,416,676,10,1,0.0,0.0,11,403,218,621,0.918639053
2447015,112,13,260,416,676,10,1,0.0,0.0,13,237,383,620,0.917159763
2447016,112,13,260,416,676,10,1,0.0,0.0,12,284,365,649,0.960059172
2447017,112,13,260,416,676,10,1,0.0,0.0,15,364,296,660,0.976331361
2449001,112,13,260,416,676,10,1,0.0,0.0,9,199,248,447,0.661242604
2449001,112,13,260,416,676,10,1,0.0,1.0,13,198,425,623,0.921597633
2449001,112,13,260,416,676,10,1,0.0,2.0,5,90,272,362,0.535502959
2450001,96,10,155,235,390,10,0,0.8,2.2,11,145,202,347,0.88974359
2450001,96,10,155,235,390,10,0,0.8,3.2,8,141,141,282,0.723076923
2450002,96,10,155,235,390,10,0,0.3,2.7,12,129,210,339,0.869230769
2450002,96,10,155,235,390,10,0,0.3,3.7,7,85,193,278,0.712820513
2450003,96,10,155,235,390,10,0,0.7,2.3,9,83,210,293,0.751282051
2450003,96,10,155,235,390,10,0,0.7,3.3,9,85,213,298,0.764102564
2450004,96,10,155,235,390,10,0,1.2,1.8,8,47,291,338,0.866666667
2450004,96,10,155,235,390,10,0,1.2,2.8,10,113,250,363,0.930769231
2451001,116,17,306,578,884,12,0,0.083333336,5.9166665,14,368,440,808,0.914027149
2451001,116,17,306,578,884,12,0,0.083333336,6.9166665,14,324,490,814,0.92081448
2452001,112,13,260,416,676,10,1,0.0,1.9,11,469,101,570,0.843195266
2452002,112,13,260,416,676,10,1,0.0,1.9,8,333,74,407,0.602071006
2452003,107,9,225,303,528,7,0,0.0,1.8571428,7,246,199,445,0.84280303
2453001,112,13,260,416,676,10,1,0.0,2.0,14,322,350,672,0.99408284
2453002,112,13,260,416,676,10,1,0.0,2.0,12,400,201,601,0.889053254
2453003,112,13,260,416,676,10,1,0.2,1.8,11,216,421,637,0.942307692
2454001,74,8,124,312,436,10,0,0.7,2.9,9,110,310,420,0.963302752
2454001,74,8,124,312,436,10,0,0.7,3.9,8,-54,478,424,0.972477064
2454001,74,8,124,312,436,10,0,0.7,4.9,10,-128,511,383,0.878440367
2454002,74,8,124,312,436,10,0,0.3,3.4,7,95,307,402,0.922018349
2454002,74,8,124,312,436,10,0,0.3,4.4,8,3,424,427,0.979357798
2454002,74,8,124,312,436,10,0,0.3,5.4,7,117,230,347,0.79587156
2454003,74,8,124,312,436,10,0,0.2,3.6,8,74,173,247,0.566513761
2454003,74,8,124,312,436,10,0,0.2,4.6,9,42,337,379,0.869266055
2454003,74,8,124,312,436,10,0,0.2,5.6,11,41,323,364,0.834862385
2454004,74,8,124,312,436,10,0,0.9,2.7,9,294,-54,240,0.550458716
2454004,74,8,124,312,436,10,0,0.9,3.7,7,193,106,299,0.685779817
2454004,74,8,124,312,436,10,0,0.9,4.7,9,165,12,177,0.405963303
2455001,100,36,1116,1116,2232,18,0,0.0,8.0,31,1093,931,2024,0.906810036
2457001,112,13,260,416,676,10,1,0.4,2.6,1,32,57,89,0.131656805
2457002,112,13,260,416,676,10,1,1.4,2.6,2,118,5,123,0.181952663
2458001,78,13,312,156,468,10,0,0.6,5.0,12,194,250,444,0.948717949
2458001,78,13,312,156,468,10,0,0.6,6.0,12,249,203,452,0.965811966
2458002,78,13,312,156,468,10,0,0.7,5.8,9,61,345,406,0.867521368
2458002,78,13,312,156,468,10,0,0.7,6.8,11,118,312,430,0.918803419
2458003,78,13,312,156,468,10,0,0.5,6.6,12,49,397,446,0.952991453
2458003,78,13,312,156,468,10,0,0.5,7.6,11,123,241,364,0.777777778
2458004,78,13,312,156,468,10,0,0.2,5.9,12,323,123,446,0.952991453
2458004,78,13,312,156,468,10,0,0.2,6.9,12,210,232,442,0.944444444
2458005,78,13,312,156,468,10,0,0.9,5.1,13,291,171,462,0.987179487
2458005,78,13,312,156,468,10,0,0.9,6.1,12,324,116,440,0.94017094
2459001,112,13,260,416,676,10,1,0.0,2.0,13,706,-66,640,0.946745562
2459002,112,13,260,416,676,10,1,0.3,1.7,11,306,321,627,0.927514793
2459003,112,13,260,416,676,10,1,0.0,2.0,11,557,43,600,0.887573964
2460001,78,13,312,156,468,10,0,0.7,9.6,6,-58,340,282,0.602564103
2460001,78,13,312,156,468,10,0,0.7,10.6,5,33,255,288,0.615384615
2460002,78,13,312,156,468,10,0,0.7,9.9,5,13,225,238,0.508547009
2460002,78,13,312,156,468,10,0,0.7,10.9,6,73,235,308,0.658119658
2460003,78,13,312,156,468,10,0,1.4,8.9,6,-60,334,274,0.585470085
2460003,78,13,312,156,468,10,0,1.4,9.9,7,-7,355,348,0.743589744
2460004,78,13,312,156,468,10,0,1.0,9.6,9,4,412,416,0.888888889
2460004,78,13,312,156,468,10,0,1.0,10.6,8,57,331,388,0.829059829
2461001,100,2,50,50,100,4,0,0.0,2.0,2,81,19,100,1.0
2463001,200,40,1140,1140,2280,16,0,0.0,2.0625,22,1161,418,1579,0.69254386
2463001,200,40,1140,1140,2280,16,0,0.0,3.0625,29,888,989,1877,0.823245614
2463001,200,40,1140,1140,2280,16,0,0.0,4.0625,30,982,896,1878,0.823684211
2464001,100,11,280,280,560,22,0,0.0,0.0,10,309,201,510,0.910714286
2464001,100,11,280,280,560,22,0,0.0,1.0,10,258,260,518,0.925
2464001,100,11,280,280,560,22,0,0.0,2.0,10,335,179,514,0.917857143
2464001,100,11,280,280,560,22,0,0.0,3.0,9,206,298,504,0.9
2465002,112,13,260,416,676,10,1,0.0,0.0,13,145,522,667,0.986686391
2465003,112,13,260,416,676,10,1,0.0,0.0,14,129,533,662,0.979289941
2466001,110,21,420,630,1050,15,0,0.2,0.8,18,-32,1015,983,0.936190476
2466001,110,21,420,630,1050,15,0,0.2,1.8,19,389,568,957,0.911428571
2466002,110,21,420,630,1050,15,0,0.13333334,0.8666667,20,340,680,1020,0.971428571
2466002,110,21,420,630,1050,15,0,0.13333334,1.8666667,15,576,323,899,0.856190476
2466003,110,21,420,630,1050,15,0,0.06666667,0.93333334,13,532,248,780,0.742857143
2466003,110,21,420,630,1050,15,0,0.06666667,1.9333333,17,644,295,939,0.894285714
2466004,110,21,420,630,1050,15,0,0.06666667,0.93333334,16,160,734,894,0.851428571
2466004,110,21,420,630,1050,15,0,0.06666667,1.9333333,15,224,645,869,0.827619048
2466005,110,21,420,630,1050,15,0,0.2,0.8,17,497,408,905,0.861904762
2466005,110,21,420,630,1050,15,0,0.2,1.8,15,459,379,838,0.798095238
2466006,110,21,420,630,1050,15,0,0.06666667,0.93333334,17,537,416,953,0.907619048
2466006,110,21,420,630,1050,15,0,0.06666667,1.9333333,20,664,375,1039,0.98952381
2466007,110,21,420,630,1050,15,0,0.06666667,0.93333334,19,399,568,967,0.920952381
2466007,110,21,420,630,1050,15,0,0.06666667,1.9333333,18,488,450,938,0.893333333
2466008,110,21,420,630,1050,15,0,0.0,1.0,16,446,459,905,0.861904762
2466008,110,21,420,630,1050,15,0,0.0,2.0,17,498,499,997,0.94952381
2466009,110,21,420,630,1050,15,0,0.0,1.0,16,411,538,949,0.903809524
2466009,110,21,420,630,1050,15,0,0.0,2.0,17,359,603,962,0.916190476
2466010,110,21,420,630,1050,15,0,0.0,1.0,18,883,111,994,0.946666667
2466010,110,21,420,630,1050,15,0,0.0,2.0,17,582,326,908,0.864761905
2466011,110,21,420,630,1050,15,0,0.0,1.0,17,259,641,900,0.857142857
2466011,110,21,420,630,1050,15,0,0.0,2.0,16,463,380,843,0.802857143
2466012,110,21,420,630,1050,15,0,0.06666667,0.93333334,19,789,190,979,0.932380952
2466012,110,21,420,630,1050,15,0,0.06666667,1.9333333,16,526,344,870,0.828571429
2467001,105,6,150,180,330,15,0,2.2,1.4666667,5,164,148,312,0.945454545
2467001,105,6,150,180,330,15,0,2.2,2.4666667,6,167,147,314,0.951515152
2467001,105,6,150,180,330,15,0,2.2,3.4666667,7,180,132,312,0.945454545
2467001,105,6,150,180,330,15,0,2.4,10.266666,5,130,142,272,0.824242424
2467001,105,6,150,180,330,15,0,2.4,11.266666,6,94,188,282,0.854545455
2467002,105,6,150,180,330,15,0,1.2666667,2.0,6,116,94,210,0.636363636
2467002,105,6,150,180,330,15,0,1.2666667,3.0,6,181,149,330,1.0
2467002,105,6,150,180,330,15,0,1.2666667,4.0,5,137,183,320,0.96969697
2467002,105,6,150,180,330,15,0,1.2666667,11.0,3,68,112,180,0.545454545
2467002,105,6,150,180,330,15,0,1.2666667,12.0,7,154,148,302,0.915151515
2469001,112,13,260,416,676,10,1,0.0,0.0,13,166,501,667,0.986686391
2469002,112,13,260,416,676,10,1,0.0,0.0,14,181,462,643,0.951183432
2469003,112,13,260,416,676,10,1,0.0,0.0,11,87,511,598,0.884615385
2469004,112,13,260,416,676,10,1,0.0,0.0,12,132,459,591,0.874260355
2472001,115,107,1890,3522,5412,75,0,0.0,1.0,20,659,232,891,0.164634146
2474001,112,13,260,416,676,10,1,0.0,4.5,11,243,385,628,0.928994083
2475001,100,15,435,435,870,7,0,0.0,13.0,11,235,454,689,0.791954023
2475001,100,15,435,435,870,7,0,0.0,14.0,10,162,433,595,0.683908046
2475001,100,15,435,435,870,7,0,0.0,15.0,11,248,441,689,0.791954023
2476001,112,13,260,416,676,10,1,2.3,2.7,12,234,411,645,0.954142012
2476002,112,13,260,416,676,10,1,2.1,2.8,9,215,344,559,0.826923077
2476003,112,13,260,416,676,10,1,2.3,2.6,12,304,342,646,0.955621302
2476004,112,13,260,416,676,10,1,1.2,3.8,11,341,253,594,0.878698225
2476005,112,13,260,416,676,10,1,1.6,3.4,12,321,324,645,0.954142012
2477001,659,9,2142,1098,3240,10,0,0.2,5.1,12,518,2016,2534,0.782098765
2477002,659,9,2142,1098,3240,10,0,0.4,5.0,12,1781,781,2562,0.790740741
2477003,659,9,2142,1098,3240,10,0,0.7,4.1,13,573,1613,2186,0.674691358
2477004,659,9,2142,1098,3240,10,0,0.4,4.4,13,1148,1322,2470,0.762345679
2477005,659,9,2142,1098,3240,10,0,0.6,4.4,12,2102,376,2478,0.764814815
2477006,659,9,2142,1098,3240,10,0,0.6,4.3,10,2126,567,2693,0.83117284
2477007,659,9,2142,1098,3240,10,0,0.6,4.7,10,2287,660,2947,0.909567901
2480001,112,9,180,288,468,6,0,0.0,1.0,9,74,394,468,1.0
2482001,65,13,780,390,1170,10,0,0.6,5.0,10,234,786,1020,0.871794872
2482001,65,13,780,390,1170,10,0,0.6,6.0,7,79,781,860,0.735042735
2482002,65,13,780,390,1170,10,0,0.4,4.3,10,-36,1141,1105,0.944444444
2482002,65,13,780,390,1170,10,0,0.4,5.3,8,111,889,1000,0.854700855
2482003,65,13,780,390,1170,10,0,0.8,3.3,8,-392,1282,890,0.760683761
2482003,65,13,780,390,1170,10,0,0.8,4.3,6,132,533,665,0.568376068
2482004,65,13,780,390,1170,10,0,1.3,3.5,10,-3,1063,1060,0.905982906
2482004,65,13,780,390,1170,10,0,1.3,4.5,7,106,634,740,0.632478632
2482005,65,13,780,390,1170,10,0,2.0,3.6,10,-359,1354,995,0.85042735
2482005,65,13,780,390,1170,10,0,2.0,4.6,6,150,535,685,0.585470085
2482008,70,3,195,120,315,2,0,1.5,5.0,1,30,150,180,0.571428571
2484001,550,9,1242,1242,2484,10,0,0.2,1.1,12,142,2050,2192,0.882447665
2484002,550,9,1242,1242,2484,10,0,0.2,1.1,13,1535,401,1936,0.779388084
2484003,550,9,1242,1242,2484,10,0,0.2,1.0,11,1468,728,2196,0.884057971
2484004,550,9,1242,1242,2484,10,0,0.3,1.0,10,294,2158,2452,0.987117552
2484005,550,9,1242,1242,2484,10,0,0.1,1.2,9,1462,910,2372,0.954911433
2484006,550,9,1242,1242,2484,10,0,0.2,1.4,8,1383,433,1816,0.731078905
2484007,550,9,1242,1242,2484,10,0,0.0,1.0,13,388,1520,1908,0.768115942
2484008,550,9,1242,1242,2484,10,0,0.3,0.9,12,678,1598,2276,0.91626409
2484009,550,9,1242,1242,2484,10,0,0.2,1.0,12,1616,492,2108,0.84863124
2486001,50,7,182,182,364,20,0,0.0,3.0,6,-34,306,272,0.747252747
2487001,112,13,260,416,676,10,1,0.0,1.0,13,188,483,671,0.99260355
2487002,112,13,260,416,676,10,1,0.0,1.0,14,489,169,658,0.973372781
2487003,112,13,260,416,676,10,1,0.0,1.0,14,168,504,672,0.99408284
2487004,112,13,260,416,676,10,1,0.0,0.9,12,208,464,672,0.99408284
2487005,112,13,260,416,676,10,1,0.0,1.0,13,280,369,649,0.960059172
2487006,112,13,260,416,676,10,1,0.0,1.0,12,206,343,549,0.812130178
2487007,112,9,180,288,468,6,0,0.0,0.8333333,6,202,164,366,0.782051282
2488001,550,15,3750,3750,7500,20,0,0.0,2.15,21,-978,4378,3400,0.453333333
2488002,550,15,3750,3750,7500,20,0,0.0,2.1,20,2816,1984,4800,0.64
2488003,550,15,3750,3750,7500,20,0,0.0,1.95,19,1158,3842,5000,0.666666667
2488004,550,15,3750,3750,7500,20,0,0.0,2.0,19,4050,-50,4000,0.533333333
2488005,550,15,3750,3750,7500,20,0,0.0,2.15,22,941,2859,3800,0.506666667
2488006,550,15,3750,3750,7500,20,0,0.0,1.9,18,364,4036,4400,0.586666667
2488007,550,15,3750,3750,7500,20,0,0.0,2.0,16,3731,-1431,2300,0.306666667
2488008,550,15,3750,3750,7500,20,0,0.0,1.9,22,3286,-386,2900,0.386666667
2488009,550,15,3750,3750,7500,20,0,0.0,1.95,18,879,1221,2100,0.28
2488010,550,15,3750,3750,7500,20,0,0.0,1.95,20,4624,-1424,3200,0.426666667
2488011,550,15,3750,3750,7500,20,0,0.0,1.95,19,296,4604,4900,0.653333333
2488012,550,15,3750,3750,7500,14,0,0.0,2.0,12,5444,-344,5100,0.68
2490001,155,52,1425,1446,2871,39,0,0.74358976,3.7435896,44,1876,694,2570,0.895158481
2490001,155,52,1425,1446,2871,39,0,0.74358976,4.74359,47,1558,1142,2700,0.940438871
2490001,155,52,1425,1446,2871,39,0,0.74358976,5.74359,45,1421,1192,2613,0.910135841
2491001,108,192,3997,5668,9665,151,0,0.0,0.9933775,113,807,5454,6261,0.647801345
2492001,100,24,648,648,1296,17,0,0.0,10.0,23,289,933,1222,0.942901235
2492001,100,24,648,648,1296,17,0,0.0,11.0,24,576,680,1256,0.969135802
2492001,100,24,648,648,1296,17,0,0.0,12.0,23,882,384,1266,0.976851852
2493001,100,50,1275,1275,2550,10,0,0.0,5.8,37,1013,1097,2110,0.82745098
2493002,92,20,700,536,1236,5,0,0.0,4.8,10,785,-103,682,0.551779935
2494001,112,13,260,416,676,10,1,0.0,2.9,7,23,437,460,0.680473373
2494002,112,13,260,416,676,10,1,0.0,3.0,11,138,479,617,0.912721893
2494003,107,9,225,303,528,7,0,0.0,2.5714285,3,-130,394,264,0.5
2496001,98,45,1260,1170,2430,19,0,0.0,9.894737,26,1168,653,1821,0.749382716
2497001,102,51,1413,1332,2745,37,0,2.945946,4.4324327,42,1781,767,2548,0.928233151
2498001,80,9,270,270,540,19,0,0.0,20.210526,9,206,319,525,0.972222222
2498001,80,9,270,270,540,19,0,0.0,21.210526,9,180,360,540,1.0
2498001,80,9,270,270,540,19,0,0.0,22.210526,9,184,351,535,0.990740741
2498001,80,9,270,270,540,19,0,0.0,23.210526,8,171,304,475,0.87962963
2499001,96,10,155,235,390,10,0,0.1,2.9,7,81,210,291,0.746153846
2499001,96,10,155,235,390,10,0,0.1,3.9,8,113,248,361,0.925641026
2499002,96,10,155,235,390,10,0,1.0,2.0,7,5,320,325,0.833333333
2499002,96,10,155,235,390,10,0,1.0,3.0,7,51,252,303,0.776923077
2500001,95,6,180,150,330,5,0,0.0,1.0,6,319,-29,290,0.878787879
2501001,500,11,1760,1760,3520,10,0,0.4,2.0,13,1911,1381,3292,0.935227273
2501002,500,11,1760,1760,3520,10,0,0.1,1.9,12,2131,1261,3392,0.963636364
2501003,500,11,1760,1760,3520,10,0,0.5,1.9,13,1438,1854,3292,0.935227273
2501004,500,11,1760,1760,3520,10,0,0.1,2.2,13,1259,2033,3292,0.935227273
2501005,500,11,1760,1760,3520,10,0,0.3,2.0,12,2595,545,3140,0.892045455
2501006,500,11,1760,1760,3520,10,0,0.2,2.2,13,1764,1556,3320,0.943181818
2501007,500,11,1760,1760,3520,10,0,0.3,1.9,14,2816,432,3248,0.922727273
2501008,500,11,1760,1760,3520,10,0,0.2,1.9,15,340,2780,3120,0.886363636
2501009,500,11,1760,1760,3520,10,0,0.4,2.0,13,1278,2070,3348,0.951136364
2502001,112,13,260,416,676,10,1,0.0,0.0,14,44,623,667,0.986686391
2502001,112,13,260,416,676,10,1,0.0,1.0,13,207,454,661,0.977810651
2502001,112,13,260,416,676,10,1,0.0,2.0,12,238,423,661,0.977810651
2502001,112,13,260,416,676,10,1,0.0,3.0,13,254,407,661,0.977810651
2502001,112,13,260,416,676,10,1,0.0,4.0,14,251,416,667,0.986686391
2502001,112,13,260,416,676,10,1,0.0,5.0,13,240,427,667,0.986686391
2502001,112,13,260,416,676,10,1,0.0,6.0,11,230,382,612,0.905325444
2502001,112,13,260,416,676,10,1,0.0,7.0,12,205,425,630,0.931952663
2502001,112,13,260,416,676,10,1,0.0,8.0,9,-106,606,500,0.73964497
2502002,112,13,260,416,676,10,1,0.0,0.0,8,112,363,475,0.702662722
2502002,112,13,260,416,676,10,1,0.0,1.0,10,70,463,533,0.788461538
2502002,112,13,260,416,676,10,1,0.0,2.0,9,153,370,523,0.773668639
2502002,112,13,260,416,676,10,1,0.0,3.0,9,163,387,550,0.813609467
2502002,112,13,260,416,676,10,1,0.0,4.0,11,322,212,534,0.789940828
2502002,112,13,260,416,676,10,1,0.0,5.0,12,386,268,654,0.967455621
2502002,112,13,260,416,676,10,1,0.0,6.0,12,369,279,648,0.958579882
2502002,112,13,260,416,676,10,1,0.0,7.0,7,275,76,351,0.519230769
2502002,112,13,260,416,676,10,1,0.0,8.0,3,78,71,149,0.220414201
2502003,112,13,260,416,676,10,1,0.0,0.0,9,13,476,489,0.723372781
2502003,112,13,260,416,676,10,1,0.0,1.0,6,48,372,420,0.621301775
2502003,112,13,260,416,676,10,1,0.0,2.0,8,13,438,451,0.667159763
2502003,112,13,260,416,676,10,1,0.0,3.0,7,11,459,470,0.695266272
2502003,112,13,260,416,676,10,1,0.0,4.0,9,78,429,507,0.75
2502003,112,13,260,416,676,10,1,0.0,5.0,9,72,495,567,0.838757396
2502003,112,13,260,416,676,10,1,0.0,6.0,9,105,417,522,0.772189349
2502003,112,13,260,416,676,10,1,0.0,7.0,11,-27,621,594,0.878698225
2502003,112,13,260,416,676,10,1,0.0,8.0,2,39,99,138,0.204142012
2502004,112,13,260,416,676,10,1,0.0,0.0,9,118,406,524,0.775147929
2502004,112,13,260,416,676,10,1,0.0,1.0,10,101,428,529,0.782544379
2502004,112,13,260,416,676,10,1,0.0,2.0,9,115,449,564,0.834319527
2502004,112,13,260,416,676,10,1,0.0,3.0,9,112,392,504,0.74556213
2502004,112,13,260,416,676,10,1,0.0,4.0,11,181,368,549,0.812130178
2502004,112,13,260,416,676,10,1,0.0,5.0,10,213,368,581,0.859467456
2502004,112,13,260,416,676,10,1,0.0,6.0,12,204,446,650,0.961538462
2502004,112,13,260,416,676,10,1,0.0,7.0,8,137,321,458,0.677514793
2502004,112,13,260,416,676,10,1,0.0,8.0,6,110,233,343,0.50739645
2502005,112,13,260,416,676,10,1,0.0,0.0,9,151,350,501,0.74112426
2502005,112,13,260,416,676,10,1,0.0,1.0,13,-156,800,644,0.952662722
2502005,112,13,260,416,676,10,1,0.0,2.0,11,-6,605,599,0.886094675
2502005,112,13,260,416,676,10,1,0.0,3.0,9,341,160,501,0.74112426
2502005,112,13,260,416,676,10,1,0.0,4.0,13,135,518,653,0.965976331
2502005,112,13,260,416,676,10,1,0.0,5.0,10,159,404,563,0.832840237
2502005,112,13,260,416,676,10,1,0.0,6.0,13,84,581,665,0.983727811
2502005,112,13,260,416,676,10,1,0.0,7.0,12,44,577,621,0.918639053
2502005,112,13,260,416,676,10,1,0.0,8.0,3,35,194,229,0.338757396
2503001,112,13,260,416,676,10,1,0.0,1.0,10,263,319,582,0.860946746
2503001,112,13,260,416,676,10,1,0.0,2.0,10,170,424,594,0.878698225
2503001,112,13,260,416,676,10,1,0.0,3.0,12,192,454,646,0.955621302
2503002,112,13,260,416,676,10,1,0.0,1.0,12,311,329,640,0.946745562
2503002,112,13,260,416,676,10,1,0.0,2.0,12,367,295,662,0.979289941
2503002,112,13,260,416,676,10,1,0.0,3.0,12,349,301,650,0.961538462
2503003,112,13,260,416,676,10,1,0.0,1.0,10,1,592,593,0.877218935
2503003,112,13,260,416,676,10,1,0.0,2.0,11,86,524,610,0.902366864
2503003,112,13,260,416,676,10,1,0.0,3.0,14,233,436,669,0.98964497
2503004,112,13,260,416,676,10,1,0.0,1.0,14,318,344,662,0.979289941
2503004,112,13,260,416,676,10,1,0.0,2.0,10,417,190,607,0.897928994
2503004,112,13,260,416,676,10,1,0.0,3.0,14,526,138,664,0.982248521
2504001,112,13,260,416,676,10,1,0.1,0.9,9,313,192,505,0.74704142
2504002,112,13,260,416,676,10,1,0.1,0.8,7,28,432,460,0.680473373
2504003,112,13,260,416,676,10,1,0.0,1.0,11,229,414,643,0.951183432
2504004,112,13,260,416,676,10,1,0.1,0.9,8,375,106,481,0.711538462
2504005,112,13,260,416,676,10,1,0.1,0.9,12,244,396,640,0.946745562
2504006,112,13,260,416,676,10,1,0.1,1.6,11,-73,667,594,0.878698225
2504007,112,13,260,416,676,10,1,0.0,1.0,9,439,108,547,0.809171598
2504008,112,13,260,416,676,10,1,0.2,0.8,11,342,267,609,0.900887574
2505001,75,4,58,58,116,10,0,1.2,0.8,8,-200,166,-34,-0.293103448
2505002,75,4,58,58,116,10,0,1.0,1.0,4,16,100,116,1.0
2505003,75,4,58,58,116,10,0,0.9,0.8,6,-14,62,48,0.413793103
2505004,75,4,58,58,116,10,0,1.2,0.8,5,65,24,89,0.767241379
2505005,75,4,58,58,116,10,0,1.1,0.9,6,65,-38,27,0.232758621
2505006,75,4,58,58,116,10,0,1.0,1.0,5,49,12,61,0.525862069
2506001,187,23,1334,1311,2645,21,0,0.0,0.0,22,1421,984,2405,0.90926276
2506001,187,23,1334,1311,2645,21,0,0.0,1.0,25,1576,909,2485,0.939508507
2506001,187,23,1334,1311,2645,21,0,0.0,2.0,19,1279,996,2275,0.860113422
2506001,187,23,1334,1311,2645,21,0,0.0,3.0,21,1632,803,2435,0.920604915
2506001,187,23,1334,1311,2645,21,0,0.0,4.0,21,1480,945,2425,0.916824197
2506001,187,23,1334,1311,2645,21,0,0.0,5.0,24,1524,1046,2570,0.971644612
2506001,187,23,1334,1311,2645,21,0,0.0,6.0,21,1572,723,2295,0.867674858
2508001,78,13,312,156,468,10,0,1.1,9.9,12,161,279,440,0.94017094
2508001,78,13,312,156,468,10,0,1.1,10.9,11,216,218,434,0.927350427
2508002,78,13,312,156,468,10,0,1.7,10.1,13,485,-25,460,0.982905983
2508002,78,13,312,156,468,10,0,1.7,11.1,14,547,-91,456,0.974358974
2508003,78,13,312,156,468,10,0,2.2,8.8,13,209,219,428,0.914529915
2508003,78,13,312,156,468,10,0,2.2,9.8,11,134,292,426,0.91025641
2509001,100,16,240,240,480,20,0,0.0,0.0,16,333,55,388,0.808333333
2509001,100,16,240,240,480,20,0,0.0,1.0,18,240,134,374,0.779166667
2509001,100,16,240,240,480,20,0,0.0,2.0,16,250,188,438,0.9125
2509002,100,16,240,240,480,20,0,0.0,0.0,21,-33,383,350,0.729166667
2509002,100,16,240,240,480,20,0,0.0,1.0,21,73,225,298,0.620833333
2509002,100,16,240,240,480,20,0,0.0,2.0,22,27,305,332,0.691666667
2509003,100,16,240,240,480,20,0,0.0,0.0,20,-32,376,344,0.716666667
2509003,100,16,240,240,480,20,0,0.0,1.0,19,64,318,382,0.795833333
2509003,100,16,240,240,480,20,0,0.0,2.0,20,99,255,354,0.7375
2509004,100,16,240,240,480,20,0,0.0,0.2,19,-320,614,294,0.6125
2509004,100,16,240,240,480,20,0,0.0,1.2,18,53,353,406,0.845833333
2509004,100,16,240,240,480,20,0,0.0,2.2,20,102,290,392,0.816666667
2509005,100,16,240,240,480,20,0,0.0,0.0,14,76,298,374,0.779166667
2509005,100,16,240,240,480,20,0,0.0,1.0,18,158,262,420,0.875
2509005,100,16,240,240,480,20,0,0.0,2.0,20,86,288,374,0.779166667
2509006,100,16,240,240,480,20,0,0.0,0.0,17,87,247,334,0.695833333
2509006,100,16,240,240,480,20,0,0.0,1.0,17,123,263,386,0.804166667
2509006,100,16,240,240,480,20,0,0.0,2.0,21,154,192,346,0.720833333
2509007,100,16,240,240,480,20,0,0.0,0.0,17,-44,372,328,0.683333333
2509007,100,16,240,240,480,20,0,0.0,1.0,19,165,245,410,0.854166667
2509007,100,16,240,240,480,20,0,0.0,2.0,17,178,182,360,0.75
2509008,100,16,240,240,480,20,0,0.0,0.0,16,83,269,352,0.733333333
2509008,100,16,240,240,480,20,0,0.0,1.0,18,303,9,312,0.65
2509008,100,16,240,240,480,20,0,0.0,2.0,16,267,87,354,0.7375
2509009,100,16,240,240,480,20,0,0.0,0.0,19,23,305,328,0.683333333
2509009,100,16,240,240,480,20,0,0.0,1.0,19,101,269,370,0.770833333
2509009,100,16,240,240,480,20,0,0.0,2.0,22,136,164,300,0.625
2509010,100,16,240,240,480,20,0,0.0,0.0,12,-106,410,304,0.633333333
2509010,100,16,240,240,480,20,0,0.0,1.0,20,-87,347,260,0.541666667
2509010,100,16,240,240,480,20,0,0.0,2.0,19,104,228,332,0.691666667
2510001,114,30,645,1050,1695,20,0,0.0,1.9,23,868,478,1346,0.794100295
2510001,114,30,645,1050,1695,20,0,0.0,2.9,25,750,715,1465,0.864306785
2510001,114,30,645,1050,1695,20,0,0.0,3.9,26,468,1026,1494,0.881415929
2510002,114,30,645,1050,1695,20,0,0.0,1.85,27,338,1279,1617,0.953982301
2510002,114,30,645,1050,1695,20,0,0.0,2.85,28,-92,1713,1621,0.956342183
2510002,114,30,645,1050,1695,20,0,0.0,3.85,27,202,1373,1575,0.92920354
2510003,111,21,546,789,1335,15,0,0.0,1.6,12,576,232,808,0.605243446
2510003,111,21,546,789,1335,15,0,0.0,2.6,14,552,380,932,0.698127341
2510003,111,21,546,789,1335,15,0,0.0,3.6,12,522,278,800,0.599250936
2511001,105,12,276,330,606,9,0,0.0,4.0,9,468,60,528,0.871287129
2513001,550,15,3750,3750,7500,20,0,0.0,3.7,16,4477,1423,5900,0.786666667
2513002,550,15,3750,3750,7500,20,0,0.05,3.4,11,3788,612,4400,0.586666667
2513003,550,15,3750,3750,7500,20,0,0.1,3.5,17,1917,2083,4000,0.533333333
2513004,550,15,3750,3750,7500,20,0,0.05,3.65,18,4724,-924,3800,0.506666667
2513005,550,15,3750,3750,7500,20,0,0.0,3.9,16,2035,3965,6000,0.8
2513006,550,15,3750,3750,7500,20,0,0.05,3.55,16,4805,-805,4000,0.533333333
2513007,550,15,3750,3750,7500,20,0,0.25,3.25,19,5359,-459,4900,0.653333333
2513008,550,15,3750,3750,7500,20,0,0.05,3.55,16,-580,4380,3800,0.506666667
2513009,550,15,3750,3750,7500,12,0,0.0,3.0,11,4833,1667,6500,0.866666667
2515001,108,12,270,366,636,9,0,0.0,3.0,10,-20,615,595,0.935534591
2515001,108,12,270,366,636,9,0,0.0,4.0,8,236,256,492,0.773584906
2515001,108,12,270,366,636,9,0,0.0,5.0,11,302,325,627,0.985849057
2519002,112,13,260,416,676,10,1,0.0,2.0,14,419,236,655,0.968934911
2519006,112,13,260,416,676,10,1,0.5,1.9,12,237,372,609,0.900887574
2519007,112,13,260,416,676,10,1,0.0,1.9,12,18,540,558,0.825443787
2522001,107,15,330,435,765,14,0,0.5,3.357143,17,178,537,715,0.934640523
2522002,107,15,330,435,765,14,0,0.21428572,3.7857144,18,95,591,686,0.896732026
2523001,100,51,1275,1275,2550,35,0,0.0,1.6,36,527,1377,1904,0.746666667
2523002,100,51,1275,1275,2550,35,0,0.0,1.3428571,30,929,716,1645,0.645098039
2523003,100,33,924,942,1866,23,0,0.0,1.4347826,23,663,635,1298,0.695605573
2527001,659,9,2142,1098,3240,10,0,0.3,5.1,9,1022,1935,2957,0.912654321
2527002,659,9,2142,1098,3240,10,0,0.3,5.7,11,1252,891,2143,0.661419753
2527003,659,9,2142,1098,3240,10,0,0.9,4.8,12,-1008,3144,2136,0.659259259
2527004,659,9,2142,1098,3240,10,0,0.4,4.9,10,1419,1446,2865,0.884259259
2527005,659,9,2142,1098,3240,10,0,0.2,6.2,10,1765,1214,2979,0.919444444
2527006,659,9,2142,1098,3240,10,0,0.9,5.3,9,247,2511,2758,0.851234568
2527007,659,9,2142,1098,3240,10,0,0.5,5.3,9,2309,365,2674,0.825308642
2527008,659,9,2142,1098,3240,10,0,1.0,5.4,11,850,1805,2655,0.819444444
2528001,75,10,390,390,780,30,0,0.0,0.0,10,-6,418,412,0.528205128
2528001,75,10,390,390,780,30,0,0.0,1.0,13,370,276,646,0.828205128
2528001,75,10,390,390,780,30,0,0.0,2.0,11,470,220,690,0.884615385
2528001,75,10,390,390,780,30,0,0.0,3.0,10,337,379,716,0.917948718
2528001,75,10,390,390,780,31,0,0.0,3.8709676,11,310,260,570,0.730769231
2528001,75,10,390,390,780,31,0,0.0,4.870968,12,491,237,728,0.933333333
2529001,65,13,780,390,1170,10,0,0.4,6.1,12,63,1032,1095,0.935897436
2529001,65,13,780,390,1170,10,0,0.4,7.1,1,-205,350,145,0.123931624
2530001,112,13,260,416,676,10,1,1.1,4.1,12,417,226,643,0.951183432
2530001,112,13,260,416,676,10,1,1.1,5.1,11,384,250,634,0.937869822
2530002,112,13,260,416,676,10,1,1.2,4.0,12,460,177,637,0.942307692
2530002,112,13,260,416,676,10,1,1.2,5.0,12,67,590,657,0.971893491
2534001,101,6,154,156,310,17,0,0.0,0.9411765,7,380,-198,182,0.587096774
2535001,112,13,260,416,676,10,1,0.4,0.6,2,-107,259,152,0.224852071
2535002,112,13,260,416,676,10,1,0.3,0.7,6,-167,574,407,0.602071006
2535003,112,13,260,416,676,10,1,0.2,0.8,8,-91,580,489,0.723372781
2535004,112,13,260,416,676,10,1,0.0,1.0,6,-43,442,399,0.590236686
2535005,112,13,260,416,676,10,1,0.0,1.0,7,-784,1193,409,0.605029586
2536001,70,44,1254,1254,2508,23,0,0.0,5.869565,33,1043,1083,2126,0.8476874
2538001,78,13,312,156,468,10,0,0.9,9.3,9,-11,393,382,0.816239316
2538001,78,13,312,156,468,10,0,0.7,6.5,9,47,343,390,0.833333333
2538002,78,13,312,156,468,10,0,1.5,9.4,9,36,374,410,0.876068376
2538002,78,13,312,156,468,10,0,1.1,7.0,4,73,157,230,0.491452991
2538003,78,13,312,156,468,10,0,1.4,9.6,7,96,216,312,0.666666667
2538003,78,13,312,156,468,10,0,1.2,6.8,6,24,234,258,0.551282051
2539001,120,6,105,195,300,12,0,0.0,4.0,4,-67,309,242,0.806666667
2539001,120,6,105,195,300,12,0,0.0,5.0,5,139,124,263,0.876666667
2539001,120,6,105,195,300,12,0,0.0,6.0,6,160,140,300,1.0
2539001,120,6,105,195,300,12,0,0.0,7.0,5,148,132,280,0.933333333
2540001,117,30,525,1020,1545,20,0,0.0,2.0,29,-7,1535,1528,0.988996764
2541001,112,13,260,416,676,10,1,0.0,3.0,10,214,345,559,0.826923077
2541002,112,13,260,416,676,10,1,0.0,3.0,13,320,342,662,0.979289941
2541003,112,13,260,416,676,10,1,0.0,3.0,13,430,246,676,1.0
2541004,112,13,260,416,676,10,1,0.0,3.0,13,279,357,636,0.940828402
2541005,112,13,260,416,676,10,1,0.0,2.9,12,312,287,599,0.886094675
2541006,112,13,260,416,676,10,1,0.0,3.0,12,372,247,619,0.915680473
2541007,112,13,260,416,676,10,1,0.0,3.0,10,188,386,574,0.849112426
2541008,112,13,260,416,676,10,1,0.0,3.0,14,348,321,669,0.98964497
2541009,112,13,260,416,676,10,1,0.0,3.0,12,367,267,634,0.937869822
2541010,112,13,260,416,676,10,1,0.1,2.8,13,426,250,676,1.0
2541011,112,13,260,416,676,10,1,0.1,2.9,13,209,444,653,0.965976331
2541012,112,13,260,416,676,10,1,0.2,2.8,12,312,346,658,0.973372781
2541013,112,13,260,416,676,10,1,0.0,3.0,10,256,353,609,0.900887574
2541014,112,13,260,416,676,10,1,0.0,3.0,11,374,255,629,0.930473373
2541015,112,13,260,416,676,10,1,0.1,2.9,10,165,416,581,0.859467456
2541016,112,13,260,416,676,10,1,0.3,2.6,11,257,327,584,0.863905325
2541017,112,13,260,416,676,10,1,0.1,2.9,13,279,385,664,0.982248521
2541018,101,6,195,201,396,5,0,0.2,2.8,4,216,108,324,0.818181818
2542001,112,13,260,416,676,10,1,0.0,2.0,11,-171,755,584,0.863905325
2542002,112,13,260,416,676,10,1,0.0,2.0,6,327,107,434,0.642011834
2542003,112,13,260,416,676,10,1,0.0,2.0,6,366,48,414,0.612426036
2544001,65,13,780,390,1170,10,0,0.6,6.2,10,439,471,910,0.777777778
2544001,65,13,780,390,1170,10,0,0.6,7.2,9,-147,1017,870,0.743589744
2544002,65,13,780,390,1170,10,0,0.9,6.3,12,558,517,1075,0.918803419
2544002,65,13,780,390,1170,10,0,0.9,7.3,12,506,579,1085,0.927350427
2544003,65,13,780,390,1170,10,0,1.2,5.8,12,287,793,1080,0.923076923
2544003,65,13,780,390,1170,10,0,1.2,6.8,9,249,686,935,0.799145299
2544004,65,9,540,270,810,6,0,1.5,3.6666667,7,54,731,785,0.969135802
2547001,112,13,260,416,676,10,1,0.0,1.0,11,290,284,574,0.849112426
2547002,112,13,260,416,676,10,1,0.0,1.0,13,236,429,665,0.983727811
2547003,112,13,260,416,676,10,1,0.0,1.0,11,300,304,604,0.893491124
2547004,112,13,260,416,676,10,1,0.0,1.0,9,-77,615,538,0.795857988
2547005,112,13,260,416,676,10,1,0.0,1.0,14,63,603,666,0.985207101
2547006,112,13,260,416,676,10,1,0.0,1.0,13,288,360,648,0.958579882
2547007,112,13,260,416,676,10,1,0.0,1.0,11,483,119,602,0.890532544
2547008,112,13,260,416,676,10,1,0.0,1.0,12,446,190,636,0.940828402
2547009,112,13,260,416,676,10,1,0.0,1.0,13,354,310,664,0.982248521
2547010,112,13,260,416,676,10,1,0.0,1.0,10,383,221,604,0.893491124
2547011,112,13,260,416,676,10,1,0.0,1.0,11,191,404,595,0.880177515
2547012,112,13,260,416,676,10,1,0.0,1.0,12,335,284,619,0.915680473
2547013,112,13,260,416,676,10,1,0.0,0.9,13,172,440,612,0.905325444
2549001,137,9,405,513,918,6,0,0.0,3.0,9,583,335,918,1.0
2550001,100,7,170,170,340,14,0,0.0,6.0,7,167,173,340,1.0
